бафусам	Bafoussam
верджиния-бич	Virginia_Beach,_Virginia
вильяторо	Villatoro
атеа	Atea,_Zaragoza
висла	Wisła
алпайн	Alpine,_Texas
антиньяно	Antignano
буэнависта-де-вальдавия	Buenavista_de_Valdavia
арида,город	Arida,_Wakayama
вогьера	Voghiera
бенатки-над-йизероу	Benátky_nad_Jizerou
вильвьестре-дель-пинар	Vilviestre_del_Pinar
абу-салабих	Abu_Salabikh
анцухихи	Antsohihy
балтимор	Baltimore
буччино	Buccino
бандо,город	Bandō,_Ibaraki
ариано-нель-полезине	Ariano_nel_Polesine
альфонсине	Alfonsine
вишано	Visciano
аламогордо	Alamogordo,_New_Mexico
вильятуэльда	Villatuelda
бурса	Bursa
ашби,город	Ashby,_Minnesota
арена-по	Arena_Po
алотау	Alotau
барцио	Barzio
анголо-терме	Angolo_Terme
бедфорд,виргиния	Bedford,_Virginia
волла	Volla,_Campania
бадия-павезе	Badia_Pavese
акви-терме	Acqui_Terme
верчея	Verceia
вайтенсфельд-им-гуркталь	Weitensfeld_im_Gurktal
варацце	Varazze
веллетри	Velletri
альфано	Alfano
блумау-нойрисхоф	Blumau-Neurißhof
вонгровец	Wągrowiec
бонефро	Bonefro
баланджеро	Balangero
вайкинг,миннесота	Viking,_Minnesota
бад-блайберг	Bad_Bleiberg
авеццано	Avezzano
асакура	Asakura,_Fukuoka
аннаберг	Annaberg,_Lower_Austria
блоне	Błonie
азола	Asola,_Lombardy
валлерн,бургенланд	Wallern_im_Burgenland
биг-фолс,город	Big_Falls,_Minnesota
бакус	Backus,_Minnesota
балатон,город	Balaton,_Minnesota
брестская крепость	Brest_Fortress
бердестан	Bardestan
благовещенск	Blagoveshchensk,_Republic_of_Bashkortostan
бруньера	Brugnera
бергантино	Bergantino
бастроп	Bastrop,_Texas
вальмадрид	Valmadrid
веве	Vevey
амаравати	Amaravati,_Andhra_Pradesh
аллен	Allein
ананд,гуджарат	Anand,_Gujarat
бродзоло	Brozolo
винковцы	Vinkovci
бейрам	Beyram,_Iran
аранда-де-монкайо	Aranda_de_Moncayo
винтертур	Winterthur
амбатундразака	Ambatondrazaka
акуила-д’арроша	Aquila_d'Arroscia
буръо	Burao
бриндизи-монтанья	Brindisi_Montagna
аргусто	Argusto
аркот	Arcot,_Vellore
абаза	Abaza_(town)
велес	Veles_(city)
альбаджара	Albagiara
афрагола	Afragola
амасья	Amasya
барболес	Bárboles
ардеа	Ardea,_Lazio
балашов,город	Balashov_(town)
белиз,город	Belize_City
воскопоя	Moscopole
бивер-крик,город	Beaver_Creek,_Minnesota
виола	Viola,_Piedmont
бхагалпур	Bhagalpur
бакурцихе	Bakurtsikhe
виллальба	Villalba,_Sicily
виваро	Vivaro
арберг,берн	Aarberg
арбон	Arbon
барыш	Barysh
вайден-бай-рехниц	Weiden_bei_Rechnitz
аран-и-бидголь	Aran_va_Bidgol
вильярес-де-орбиго	Villares_de_Órbigo
вольтаджо	Voltaggio
абеокута	Abeokuta
алексеевка	Alexeyevka,_Belgorod_Oblast
аллисте	Alliste
альмонасид-де-ла-куба	Almonacid_de_la_Cuba
альтенбург	Altenburg,_Lower_Austria
вирджилио	Virgilio,_Lombardy
винадио	Vinadio
броумов	Broumov
ала-деи-сарди	Alà_dei_Sardi
брунталь	Bruntál
виальфре	Vialfrè
веркураго	Vercurago
велес-де-бенаудалья	Vélez_de_Benaudalla
виласантар	Vilasantar
акитаката	Akitakata,_Hiroshima
вуковар	Vukovar
арба	Arba,_Friuli-Venezia_Giulia
алкмар	Alkmaar
высоцк	Vysotsk
белый,город	Bely,_Tver_Oblast
волноваха	Volnovakha
верхнеуральск	Verkhneuralsk
алькубьерре	Alcubierre
вайтерсфельд	Weitersfeld
верхнеднепровск	Verkhnodniprovsk
айл	Isle,_Minnesota
аллакакет	Allakaket,_Alaska
вайкендорф	Weikendorf
алабанда	Alabanda
белтрами	Beltrami,_Minnesota
баже	Bagé
вальморея	Valmorea
абузейдабад	Abuzeydabad
висбаден	Wiesbaden
биг-лейк	Big_Lake,_Minnesota
баджер	Badger,_Minnesota
алейск	Aleysk
астара	Astara,_Iran
вилла-кастелли	Villa_Castelli
бульчаго	Bulciago
андрате	Andrate
бузет	Buzet
ареццо	Arezzo
анахайм	Anaheim,_California
арциз	Artsyz
аццанелло	Azzanello
бекабад	Bekabad
бивер-бей,миннесота	Beaver_Bay,_Minnesota
банлунг	Banlung
ансан	Ansan
буин-и-миандешт	Buin_va_Miandasht
визельбург	Wieselburg
альоса	Alloza
бигфорк,город	Bigfork,_Minnesota
агаджари	Aghajari
боржоми,город	Borjomi
бирнин-кебби	Birnin_Kebbi
брахам,миннесота	Braham,_Minnesota
село арагацотн	Aragatsotn_(village)
вентспилс	Ventspils
вильяльбилья-де-бургос	Villalbilla_de_Burgos
асков	Askov,_Minnesota
бигелоу	Bigelow,_Minnesota
бхивани	Bhiwani
валуйки	Valuyki,_Belgorod_Oblast
вянта	Venta
браоне	Braone
белосток	Białystok
бостан,хузестан	Bostan,_Iran
акутан	Akutan,_Alaska
аслор	Azlor
вальдерруэда	Valderrueda
вольфурт	Wolfurt
виллард,миннесота	Villard,_Minnesota
власиха	Vlasikha,_Moscow_Oblast
азильяно-венето	Asigliano_Veneto
виллемстад	Willemstad
африц-ам-зе	Afritz_am_See
бейт-шеан	Beit_She'an
бостан	Bostan,_Iran
боретто	Boretto
вааса	Vaasa
вальдьери	Valdieri
бок,миннесота	Bock,_Minnesota
вильдендюрнбах	Wildendürnbach
боскореале	Boscoreale
виккьо	Vicchio
альбала	Albalá
бентиу	Bentiu
асо	Aso,_Kumamoto
бедеро-валькувия	Bedero_Valcuvia
аркадия	Arcadia,_California
альтендорф	Altendorf,_Austria
вейсеяй	Veisiejai
андовер	Andover,_Minnesota
бертрум,миннесота	Burtrum,_Minnesota
астипалея	Astypalaia
владикавказ	Vladikavkaz
вайксельбаум	Weichselbaum
арвада,колорадо	Arvada,_Colorado
валенсия-де-дон-хуан	Valencia_de_Don_Juan
аццате	Azzate
аревало	Arévalo
баг-э-бехадоран	Bagh-e_Bahadoran
аннандейл,город	Annandale,_Minnesota
батоньтеренье	Bátonyterenye
багешвар	Bageshwar
бриатико	Briatico
бандера	Bandera,_Texas
азуни	Asuni
асахи,тиба	Asahi,_Chiba
бизиньяно	Bisignano
боски-сант-анна	Boschi_Sant'Anna
аквасанта-терме	Acquasanta_Terme
вестрено	Vestreno
батлер	Butler,_Missouri
вилла-фаральди	Villa_Faraldi
бризи-пойнт,миннесота	Breezy_Point,_Minnesota
валледольмо	Valledolmo
абданан	Abdanan
амбой	Amboy,_Minnesota
бонаркадо	Bonarcado
аурангабад,махараштра	Aurangabad,_Maharashtra
альбаредо-арнабольди	Albaredo_Arnaboldi
альпеньес	Alpeñés
аделанто	Adelanto,_California
бад-мускау	Bad_Muskau
альбьяте	Albiate
беркли	Berkeley,_California
барлассина	Barlassina
архонилья	Arjonilla
бихаршариф	Bihar_Sharif
абенхибре	Abengibre
аламида,город	Alameda,_California
агдам,город	Agdam
брвинув	Brwinów
вёльблинг	Wölbling
вилладозе	Villadose
брэдбери,калифорния	Bradbury,_California
аччано	Acciano
бобринец	Bobrynets
артёмово	Artemove
брандиццо	Brandizzo
бухаралос	Bujaraloz
бельви	Belvì
бородино	Borodino,_Krasnoyarsk_Krai
брусы	Brusy
бендер-конг	Kong,_Iran
брузаско	Brusasco
бонеа	Bonea
веруно	Veruno
авельяноса-де-муньо	Avellanosa_de_Muñó
альфос-де-кинтанадуэньяс	Alfoz_de_Quintanadueñas
вилория-де-риоха	Viloria_de_Rioja
апиа	Apia
вилабелья	Vilabella
амато,италия	Amato
велень	Wieleń
бербенно-ди-вальтеллина	Berbenno_di_Valtellina
альбельда	Albelda
боведа	Bóveda
боа-виста	Boa_Vista,_Roraima
ваднес-хайтс,город	Vadnais_Heights,_Minnesota
айона,миннесота	Iona,_Minnesota
бадерсдорф	Badersdorf
брионе	Brione,_Trentino
вараподьо	Varapodio
аябе	Ayabe,_Kyoto
баласор	Balasore
белиатор	Beliatore
атека	Ateca
адлисвиль	Adliswil
вербикаро	Verbicaro
беверино	Beverino
вулкан,румыния	Vulcan,_Hunedoara
аспен	Aspen,_Colorado
алькала-де-гурреа	Alcalá_de_Gurrea
альдеуэла-де-льестос	Aldehuela_de_Liestos
афтон	Afton,_Minnesota
барнум	Barnum,_Minnesota
байконур	Baikonur
власиха,область	Vlasikha,_Moscow_Oblast
ашшур,город	Assur
вау,южный судан	Wau,_South_Sudan
антиок	Antioch,_California
вольгаст	Wolgast
архангельск	Arkhangelsk
вильярино-де-лос-айрес	Villarino_de_los_Aires
альманса	Almanza
бормла	Cospicua
амбролаури	Ambrolauri
амбилубе	Ambilobe
вулвертон	Wolverton,_Minnesota
бенкулу	Bengkulu_(city)
вальмала,италия	Valmala,_Italy
брентино-беллуно	Brentino_Belluno
бриссонь	Brissogne
банци	Banzi
виррат	Virrat
алано-ди-пьяве	Alano_di_Piave
балькончан	Balconchán
вибонати	Vibonati
вольбром	Wolbrom
викторвилл,калифорния	Victorville,_California
балаклея	Balakliia
богухвала,город	Boguchwała
богданович	Bogdanovich_(town)
анджари	Angiari
бетлехем	Bethlehem,_Pennsylvania
вело-д’астико	Velo_d'Astico
вогонья	Vogogna
аррапха	Arrapha
бузано	Busano
ава	Awa,_Tokushima
ваприо-д’адда	Vaprio_d'Adda
бечов-над-теплоу	Bečov_nad_Teplou
вюрмла	Würmla
барра-ду-куараи	Barra_do_Quaraí
аш-флэт	Ash_Flat,_Arkansas
вистарино	Vistarino
банияс,город	Banias
волхов	Volkhov
безана-ин-брианца	Besana_in_Brianza
воронеж	Voronezh
альбуньяно	Albugnano
вайнона,миссисипи	Winona,_Mississippi
баборув	Baborów
безоццо	Besozzo
виница,город	Vinica,_Macedonia
бреда-ди-пьяве	Breda_di_Piave
бунвилл	Booneville,_Arkansas
валле-ломелина	Valle_Lomellina
альбалатильо	Albalatillo
айдахо-фолс	Idaho_Falls,_Idaho
бломкест	Blomkest,_Minnesota
боррелло	Borrello
бургильос-дель-серро	Burguillos_del_Cerro
брайтон	Brighton,_Colorado
архенте	Argente
вишши-брод	Vyšší_Brod
боровск	Borovsk
боболице	Bobolice
арамиль	Aramil
вильель	Villel
бьянко	Bianco
брёй-червиния	Breuil-Cervinia
брустер,город	Brewster,_Minnesota
бакингхем	Buckingham,_Quebec
барамула	Baramulla
белур	Belur
вильясека-де-ла-сагра	Villaseca_de_la_Sagra
арки	Archi,_Abruzzo
агарак	Agarak,_Syunik
вильядемор-де-ла-вега	Villademor_de_la_Vega
варри	Warri
афины	Athens
вриндавана	Vrindavan
брезова-под-брадлом	Brezová_pod_Bradlom
бакстер,миннесота	Baxter,_Minnesota
ботруньо	Botrugno
вае	Vaie
бурштын	Burshtyn
августенборг	Augustenborg,_Denmark
вильяэрмоса,табаско	Villahermosa
весполате	Vespolate
брутен,миннесота	Brooten,_Minnesota
вифлеем	Bethlehem
вольбуж,город	Wolbórz
букс,санкт-галлен	Buchs,_St._Gallen
аурайя	Auraiya
билокси,миссисипи	Biloxi,_Mississippi
вилланова-д’альбенга	Villanova_d'Albenga
вайано-кремаско	Vaiano_Cremasco
варангал	Warangal
вишнёвое	Vyshneve
брун-ам-гебирге	Brunn_am_Gebirge
альмудевар	Almudévar
ак-довурак	Ak-Dovurak
бисмарк	Bismarck,_North_Dakota
берово	Berovo
бейнбридж	Bainbridge,_Georgia
висьен	Vicién
бовино	Bovino
анауак,техас	Anahuac,_Texas
апшеронск	Apsheronsk
вальехо	Vallejo,_California
арсуф	Arsuf
бад-тибира	Bad-tibira
аниак	Aniak,_Alaska
бинджай	Binjai
боскония	Bosconia
артена	Artena
вилья-дель-росарио	Villa_del_Rosario,_Norte_de_Santander
аутильо-де-кампос	Autillo_de_Campos
венцборк	Więcbork
видеркер-вилидж,арканзас	Wiederkehr_Village,_Arkansas
байонна	Bayonne
базиано	Basiano
вальдеррей	Valderrey
венегоно-супериоре	Venegono_Superiore
ачерно	Acerno
виланова-де-прадес	Vilanova_de_Prades
бакар	Bakar
веньяно	Veniano
альбинея	Albinea
волгодонск	Volgodonsk
аспангберг-санкт-петер	Aspangberg-Sankt_Peter
волано	Volano
азов	Azov
брумов-бильнице	Brumov-Bylnice
берни	Burnie,_Tasmania
валлеротонда	Vallerotonda
амелия,город	Amelia,_Umbria
альфакар	Alfacar
берсокана	Berzocana
весковато	Vescovato,_Lombardy
агартала	Agartala
буковно	Bukowno
берра	Berra
барселуш	Barcelos,_Portugal
бирдсли	Beardsley,_Minnesota
вальзее-зиндельбург	Wallsee-Sindelburg
беноде	Bénodet
валле-кастеллана	Valle_Castellana
айрон-джанкшен	Iron_Junction,_Minnesota
вентимилья	Ventimiglia
высмежице	Wyśmierzyce
бисмарк,дакота	Bismarck,_North_Dakota
вайсвассер,лужица	Weißwasser
борау	Borau
бараджано	Baragiano
атфих	Atfih
бьютт,монтана	Butte,_Montana
арпая	Arpaia
армения,антьокия	Armenia,_Antioquia
вайнбург	Weinburg
бад	Badrud
амаюэлас-де-арриба	Amayuelas_de_Arriba
албани	Albany,_Western_Australia
вау,судан	Wau,_South_Sudan
вернберг,каринтия	Wernberg
алексеевка,город	Alexeyevka,_Belgorod_Oblast
бакус,миннесота	Backus,_Minnesota
виллафранка-пьемонте	Villafranca_Piemonte
венло	Venlo
боргосатолло	Borgosatollo
буе	Buje
болд-ноб	Bald_Knob,_Arkansas
виллар-фоккьярдо	Villar_Focchiardo
альтендорф,нижняя австрия	Altendorf,_Austria
виллареджа	Villareggia
алаканук,аляска	Alakanuk,_Alaska
ашленд,огайо	Ashland,_Ohio
ангикс	Anguix
бикин,город	Bikin
аккадия	Accadia
баков-над-йизероу	Bakov_nad_Jizerou
бенковац	Benkovac
вольфсбах,нижняя австрия	Wolfsbach
аксу,павлодарская область	Aksu,_Kazakhstan
бржидлична	Břidličná
боразджан	Borazjan
владивосток	Vladivostok
вальдеальгорфа	Valdealgorfa
бинаско	Binasco
вулф-лейк,город	Wolf_Lake,_Minnesota
валенсия-де-лас-торрес	Valencia_de_las_Torres
бальдиссеро-канавезе	Baldissero_Canavese
васильевка	Vasylivka
альтилия	Altilia
бельвилл,арканзас	Belleville,_Arkansas
аткасук	Atqasuk,_Alaska
бхилвара	Bhilwara
аннистон	Anniston,_Alabama
бенито-хуарес,кинтана-роо	Benito_Juárez_Municipality,_Quintana_Roo
альбентоса	Albentosa
альгадефе	Algadefe
балашшадьярмат	Balassagyarmat
батлер,миссури	Butler,_Missouri
бромберг	Bromberg,_Lower_Austria
бривьеска	Briviesca
барбарига	Barbariga,_Lombardy
будённовск	Budyonnovsk
беневенто	Benevento
ардженьо	Argegno
бьюкенен	Buchanan,_Michigan
базельга-ди-пине	Baselga_di_Pinè
атри,город	Atri,_Abruzzo
бендер-ленге	Bandar_Lengeh
берсоне	Bersone
волгоград	Volgograd
барцин	Barcin
богуслав,город	Bohuslav
алфа,город	Alpha,_Minnesota
битритто	Bitritto
браке,нижний везер	Brake,_Lower_Saxony
асеновград	Asenovgrad
балокко	Balocco
вилла-лагарина	Villa_Lagarina
бачено	Baceno
вольфсберг	Wolfsberg,_Carinthia
алькала-дель-хукар	Alcalá_del_Júcar
вольфсберг,каринтия	Wolfsberg,_Carinthia
вальперга	Valperga
альюэва	Allueva
аулла	Aulla
бенкулу,город	Bengkulu_(city)
антеринг	Anthering
бурбагена	Burbáguena
вильядангос-дель-парамо	Villadangos_del_Páramo
абовян,город	Abovyan
бергланд	Bergland,_Austria
вальмакка	Valmacca
бая-э-латина	Baia_e_Latina
амагасаки	Amagasaki
брион	Brión
бланско	Blansko
акбарпур	Akbarpur,_Ambedkar_Nagar
бенгела	Benguela
альхусен	Aljucén
альдеа-дель-кано	Aldea_del_Cano
валле-дель-анджело	Valle_dell'Angelo
вистрорио	Vistrorio
аулетта,кампания	Auletta
брумфилд,колорадо	Broomfield,_Colorado
бергондо	Bergondo
вавр	Wavre
вольфсграбен	Wolfsgraben
банджар	Banjar,_West_Java
баришано	Barisciano
бардсир	Bardsir
брокен-хилл,австралия	Broken_Hill,_New_South_Wales
брайслин	Bricelyn,_Minnesota
бруклин-сентер,миннесота	Brooklyn_Center,_Minnesota
вергас,миннесота	Vergas,_Minnesota
брено	Breno
бук,повят	Buk
альтурас,калифорния	Alturas,_California
броктон	Brockton,_Massachusetts
алерия	Aléria
бее	Bee,_Piedmont
альбервиль	Albertville
бей-сити,мичиган	Bay_City,_Michigan
вильямерьель	Villameriel
вольпедо	Volpedo
балестрино	Balestrino
брента	Brenta,_Lombardy
верхоянск	Verkhoyansk
брайслин,город	Bricelyn,_Minnesota
вальдеорна	Valdehorna
аткарск	Atkarsk
алзамай	Alzamay
ардон,леон	Ardón
бенин-сити	Benin_City
визано	Visano
абико	Abiko,_Chiba
виллорба	Villorba
баньос-де-монтемайор	Baños_de_Montemayor
вильхеринг	Wilhering
во,италия	Vò
боттидда	Bottidda
бальсорано	Balsorano
божи-дар	Boží_Dar
брейнерд,город	Brainerd,_Minnesota
ари,провинция кьети	Ari,_Abruzzo
вонсан	Wonsan
виллановафорру	Villanovaforru
барнум,город	Barnum,_Minnesota
бингёль	Bingöl
абадан	Abadan,_Iran
вольпельино	Volpeglino
барадили	Baradili
битола	Bitola
ариццано	Arizzano
вердерио-супериоре	Verderio_Superiore
аш	Aš
вильямартин-де-дон-санчо	Villamartín_de_Don_Sancho
богушовице-над-огржи	Bohušovice_nad_Ohří
бабушкин,бурятия	Babushkin_(town)
блэкфут,город	Blackfoot,_Idaho
валлинфреда	Vallinfreda
андрейс	Andreis
аккуафондата	Acquafondata
бельско-бяла	Bielsko-Biała
бодетт,миннесота	Baudette,_Minnesota
аксу,город	Aksu,_Kazakhstan
беллона	Bellona,_Campania
авара,город	Awara,_Fukui
берлинго	Berlingo
валандово	Valandovo
алта	Alta,_Norway
агуавива	Aguaviva
брустер	Brewster,_Minnesota
алькуэскар	Alcuéscar
валки	Valky
ватра-дорней	Vatra_Dornei
баальбек	Baalbek
абтенау	Abtenau
войнич	Wojnicz
вильяр-де-олалья	Villar_de_Olalla
акваспарта	Acquasparta
верцино	Verzino
ашби,миннесота	Ashby,_Minnesota
вельки-шариш	Veľký_Šariš
багио	Baguio
берчвуд-виллидж	Birchwood_Village,_Minnesota
альбайрате	Albairate
афтон,город	Afton,_Minnesota
вале	Vale,_Georgia
вильясидалер	Villacidaler
актонвейл	Acton_Vale,_Quebec
брони	Broni
вело-веронезе	Velo_Veronese
бардонеккья	Bardonecchia
вильядьего	Villadiego
биштынек	Bisztynek
биг-лейк,город	Big_Lake,_Minnesota
виллантерио	Villanterio
атуотер,город	Atwater,_Minnesota
биласпур,чхаттисгарх	Bilaspur,_Chhattisgarh
брайтенштайн	Breitenstein,_Lower_Austria
байрон,город	Byron,_Minnesota
биник	Binic
блэкфут,айдахо	Blackfoot,_Idaho
вольштын	Wolsztyn
брук-парк,город	Brook_Park,_Minnesota
валье-де-бардахи	Valle_de_Bardají
бурайда	Buraidah
алтуна	Altoona,_Pennsylvania
баворов,чехия	Bavorov
агульяно	Agugliano
бой-ривер,миннесота	Boy_River,_Minnesota
высока,город	Wysoka
бунвилл,арканзас	Booneville,_Arkansas
алфа	Alpha,_Minnesota
абастумани	Abastumani
бездружице	Bezdružice
вегасервера	Vegacervera
вильяр-дель-педросо	Villar_del_Pedroso
буньель	Buniel
арцана	Arzana
витково	Witkowo
аргис	Arguis
архес	Argés
ако,город	Akō,_Hyōgo
ашдод	Ashdod
биль,город	Biel/Bienne
артёмовский	Artyomovsky,_Sverdlovsk_Oblast
бизенья	Bisegna
баучи	Bauchi
антандрос	Antandrus
альтавилла-ирпина	Altavilla_Irpina
бозмен	Bozeman,_Montana
бреббья	Brebbia
вилламар	Villamar
батерст,город	Bathurst,_New_South_Wales
вольтурино	Volturino
барри,город	Barry,_Minnesota
вани	Vani
альбукерке	Albuquerque,_New_Mexico
бургильос-де-толедо	Burguillos_de_Toledo
вальдекабальерос	Valdecaballeros
бомба	Bomba,_Abruzzo
бруццано-дзеффирио	Bruzzano_Zeffirio
арзамас	Arzamas
бурынь	Buryn
виллата	Vallata
больсена	Bolsena
барасат	Barasat
бьюл,город	Buhl,_Minnesota
биджу,миннесота	Bejou,_Minnesota
биджу	Bejou,_Minnesota
белореченск	Belorechensk,_Krasnodar_Krai
бейкерсфилд	Bakersfield,_California
вальмохадо	Valmojado
вако	Wakō,_Saitama
верруа-савоя	Verrua_Savoia
вальсаваранш	Valsavarenche
бакленд	Buckland,_Alaska
армеро	Armero
брук-парк,миннесота	Brook_Park,_Minnesota
вильовьеко	Villovieco
винники	Vynnyky
буббио	Bubbio
алтус,арканзас	Altus,_Arkansas
валор	Válor
вранов-над-топлёу	Vranov_nad_Topľou
болд-ноб,арканзас	Bald_Knob,_Arkansas
вунсокет	Woonsocket,_Rhode_Island
айнажи	Ainaži
ваприо-д’агонья	Vaprio_d'Agogna
веллингтон	Wellington
арезе	Arese
бжезины	Brzeziny
битти,сардиния	Bitti
бричаны	Briceni
альтиссимо	Altissimo,_Veneto
босконеро	Bosconero
вэньчжоу	Wenzhou
бугульма	Bugulma
белгаум	Belgaum
андретта	Andretta
брэдбери	Bradbury,_California
брюкль	Brückl
боргомаро	Borgomaro
анноне-ди-брианца	Annone_di_Brianza
ангьяри	Anghiari
вилласальто	Villasalto
ахмета	Akhmeta
виньянелло	Vignanello
амстердам	Amsterdam
баньякавалло	Bagnacavallo
водо-кадоре	Vodo_di_Cadore
аки,город	Aki,_Kōchi
брентонико	Brentonico
бельведере-мариттимо	Belvedere_Marittimo
арсьеро	Arsiero
ботсфьорд	Båtsfjord
агульяро	Agugliaro
варцо	Varzo
вильярроя-де-лос-пинарес	Villarroya_de_los_Pinares
аревалильо	Arevalillo
абаде	Abadeh
бруклин-сентер	Brooklyn_Center,_Minnesota
аргайл,город	Argyle,_Minnesota
бонито	Bonito,_Campania
брукингз,южная дакота	Brookings,_South_Dakota
бессемер,алабама	Bessemer,_Alabama
агано	Agano,_Niigata
басконсильос-дель-тосо	Basconcillos_del_Tozo
бендер-махшехр	Bandar-e_Mahshahr
аволаска	Avolasca
вальделакальсада	Valdelacalzada
белчестер,миннесота	Bellechester,_Minnesota
баранцате	Baranzate
волжский	Volzhsky,_Volgograd_Oblast
вармо	Varmo
ансон	Anseong
бухара	Bukhara
аурангабад,город	Aurangabad,_Maharashtra
белая холуница	Belaya_Kholunitsa
боготол	Bogotol
баньос-де-ла-энсина	Baños_de_la_Encina
бибербах,нижняя австрия	Biberbach,_Austria
артенья	Artegna
вильялако	Villalaco
войнич,польша	Wojnicz
альцано-ломбардо	Alzano_Lombardo
анджера	Angera
брукстон	Brookston,_Minnesota
артьеда	Artieda
вигарано-майнарда	Vigarano_Mainarda
алаярви	Alajärvi
бардальюр	Bardallur
вудсток,город	Woodstock,_Minnesota
вильяобиспо-де-отеро	Villaobispo_de_Otero
баньос-де-вальдеарадос	Baños_de_Valdearados
вертавильо	Vertavillo
априкале	Apricale
биг-лейк,миннесота	Big_Lake,_Minnesota
вильянуэва-дель-дуке	Villanueva_del_Duque
бхаруч	Bharuch
аннополь,город	Annopol
альдеануэва-де-сан-бартоломе	Aldeanueva_de_San_Bartolomé
арканзас-сити,арканзас	Arkansas_City,_Arkansas
берцано-ди-тортона	Berzano_di_Tortona
бодокена	Bodoquena
асбест,город	Asbest
брудзоло	Bruzolo
вальфарта	Valfarta
альбек,каринтия	Albeck,_Carinthia
вергас	Vergas,_Minnesota
ангвиллара-сабация	Anguillara_Sabazia
бржезова	Březová_(Sokolov_District)
бельмонте-калабро	Belmonte_Calabro
бюль	Bulle
бад-гроспертхольц	Bad_Großpertholz
барвице	Barwice
войковице	Wojkowice
барчево	Barczewo
баньярия	Bagnaria
вольпаго-монтелло	Volpago_del_Montello
бровелло-карпуньино	Brovello-Carpugnino
бадия-тедальда	Badia_Tedalda
вальпрато-соана	Valprato_Soana
борсо-дель-граппа	Borso_del_Grappa
амоль	Amol
вальгризанш	Valgrisenche
белл-плейн,город	Belle_Plaine,_Minnesota
вилларбассе	Villarbasse
борго-сан-джованни	Borgo_San_Giovanni
бенсон,город	Benson,_Minnesota
арлон	Arlon
бужумбура	Bujumbura
вальтурнанш	Valtournenche
боннерс-ферри,айдахо	Bonners_Ferry,_Idaho
вила-родона	Vila-rodona
бунгооно	Bungo-ōno,_Ōita
вианден	Vianden
бардо,нижнесилезское воеводство	Bardo,_Poland
боулдер,колорадо	Boulder,_Colorado
альберона	Alberona
арройо-де-ла-лус	Arroyo_de_la_Luz
бопре	Beaupré,_Quebec
блейн,миннесота	Blaine,_Minnesota
боттичино	Botticino
белтрами,миннесота	Beltrami,_Minnesota
амион	Amioun
альхартсберг	Allhartsberg
барассо	Barasso
вильяморатьель-де-лас-матас	Villamoratiel_de_las_Matas
батл-лейк	Battle_Lake,_Minnesota
вашковцы	Vashkivtsi
вильянуэва-де-арганьо	Villanueva_de_Argaño
андреаполь	Andreapol
арцано	Arzano
авалон	Avalon,_California
ашшур	Assur
вильянуэва-де-ла-рейна	Villanueva_de_la_Reina
анахайм,калифорния	Anaheim,_California
бржезнице	Březnice_(Příbram_District)
березно	Berezne
боза,сардиния	Bosa
вупперталь	Wuppertal
ахау	Achau
вернио	Vernio
вайстрах	Weistrach
винчи,город	Vinci,_Tuscany
аниньон	Aniñón
брустер,миннесота	Brewster,_Minnesota
брумфилд	Broomfield,_Colorado
ахва	Ahwa
алван	Alvan,_Iran
валледория	Valledoria
вайнцирль-ам-вальде	Weinzierl_am_Walde
вилла-санта-лучия	Villa_Santa_Lucia
бёхаймкирхен	Böheimkirchen
альпартир	Alpartir
абиджан	Abidjan
авеллино	Avellino
битунг	Bitung
бингемтон	Binghamton,_New_York
альпандейре	Alpandeire,_Spain
браке	Brake,_Lower_Saxony
абдан	Abdan
биль	Biel/Bienne
байконур,город	Baikonur
ачи-катена	Aci_Catena
вышгород,украина	Vyshhorod
месторождение ассалуйе	Asaluyeh
биньчжоу	Binzhou
весп	Weesp
анрас	Anras
анкува	Ankuwa
бельмонте-дель-саннио	Belmonte_del_Sannio
вильянуэва-де-ла-вера	Villanueva_de_la_Vera
вьякамп-и-литера	Viacamp_y_Litera
аффи	Affi
асануй-алинс	Azanuy-Alins
коммуна амаро	Amaro,_Friuli
бисмарк,северная дакота	Bismarck,_North_Dakota
вильятурьель	Villaturiel
бельмонте-де-кампос	Belmonte_de_Campos
барге	Barghe
апиро	Apiro
анамур	Anamur
бринцио	Brinzio
борегард,приход	Beauregard_Parish,_Louisiana
вердуно	Verduno
бад-зауэрбрунн	Bad_Sauerbrunn
вильота-дель-парамо	Villota_del_Páramo
бедония	Bedonia
вильянуньо-де-вальдавия	Villanuño_de_Valdavia
анвик,аляска	Anvik,_Alaska
бунди	Bundi
бернхардсталь	Bernhardsthal
валье-де-ока	Valle_de_Oca
бриджпорт,коннектикут	Bridgeport,_Connecticut
армения	Armenia,_Antioquia
бакман	Buckman,_Minnesota
валле-моссо	Valle_Mosso
блэкдак	Blackduck,_Minnesota
арзон	Arzon
вильямуэлас	Villamuelas
возники	Woźniki
бенито-хуарес	Benito_Juárez_Municipality,_Quintana_Roo
вашингтон-на-бразосе	Washington-on-the-Brazos,_Texas
вильяэрмоса	Villahermosa
браунс-валли,миннесота	Browns_Valley,_Minnesota
буин	Buin_Zahra
визен	Wiesen,_Austria
брекенридж,город	Breckenridge,_Minnesota
боубеллс	Bowbells,_North_Dakota
вальганна	Valganna
агаджари,хузестан	Aghajari
вилла-миноццо	Villa_Minozzo
вилласпекьоза	Villaspeciosa
вильянуэва-де-лас-торрес	Villanueva_de_las_Torres
боччолето	Boccioleto
александруполис	Alexandroupoli
авара	Awara,_Fukui
братск	Bratsk
бен,чехармехаль и бахтиария	Ben,_Iran
бельви,италия	Belvì
бусто-арсицио	Busto_Arsizio
аюд	Aiud
вонсош	Wąsosz
волин,город	Wolin_(town)
адамов,район бланско	Adamov_(Blansko_District)
балатон,миннесота	Balaton,_Minnesota
акбарпур,амбедкарнагар	Akbarpur,_Ambedkar_Nagar
белява	Bielawa
бриенца	Brienza
бандо	Bandō,_Ibaraki
айтос	Aytos
вальес-де-паленсуэла	Valles_de_Palenzuela
бревик	Brevik
врбно-под-прадедем	Vrbno_pod_Pradědem
вараждинске-топлице	Varaždinske_Toplice
васто	Vasto
бодайбо,город	Bodaybo
вико-канавезе	Vico_Canavese
алькала-де-эбро	Alcalá_de_Ebro
вальдефуэнтес-дель-парамо	Valdefuentes_del_Páramo
вайсенкирхен-ан-дер-першлинг	Weißenkirchen_an_der_Perschling
арден-хилс	Arden_Hills,_Minnesota
арсаго-сеприо	Arsago_Seprio
велес,город	Veles_(city)
авока,миннесота	Avoca,_Minnesota
алькала-де-ла-сельва	Alcalá_de_la_Selva
влашим	Vlašim
армази	Armazi
анантапур,город	Anantapur,_Andhra_Pradesh
альфос-де-санта-гадеа	Alfoz_de_Santa_Gadea
биреджик	Birecik
акуне	Akune,_Kagoshima
вас	Vas,_Veneto
айелло-дель-сабато	Aiello_del_Sabato
вудленд,город	Woodland,_Minnesota
вильхельмсбург,австрия	Wilhelmsburg,_Austria
альяно-терме	Agliano_Terme
боргоратто-алессандрино	Borgoratto_Alessandrino
арпаизе	Arpaise
верво	Vervò
викторвилл	Victorville,_California
борислав	Boryslav
багли	Bagley,_Minnesota
бен,и	Ben,_Iran
альберндорф-им-пулькауталь	Alberndorf_im_Pulkautal
барретт,миннесота	Barrett,_Minnesota
вессалико	Vessalico
видракко	Vidracco
вольтурара-ирпина	Volturara_Irpina
вргорац	Vrgorac
бжозув	Brzozów
бальбоа,леон	Balboa,_León
арнольдштайн	Arnoldstein
вудсток	Woodstock,_Minnesota
вилла-сант-антонио	Villa_Sant'Antonio
брённёйсунн	Brønnøysund
беллвилл	Belleville,_Illinois
ашкелон	Ashkelon
брутен	Brooten,_Minnesota
армянск	Armyansk
брокен-боу,небраска	Broken_Bow,_Nebraska
виборг	Viborg,_Denmark
атцара	Atzara
вильясбуэнас-де-гата	Villasbuenas_de_Gata
альбенга	Albenga
быдгощ	Bydgoszcz
агдам	Agdam
бриджпорт	Bridgeport,_Connecticut
аппиньяно	Appignano
балтийск	Baltiysk
бергама	Bergama
виллафранка-ди-верона	Villafranca_di_Verona
бая-маре	Baia_Mare
валло-торинезе	Vallo_Torinese
бонанса	Bonansa
вильяфранка-де-эбро	Villafranca_de_Ebro
банбери	Bunbury,_Western_Australia
бове	Beauvais
вильяркайо-де-мериндад-де-кастилья-ла-вьеха	Villarcayo_de_Merindad_de_Castilla_la_Vieja
бастилья	Bastiglia
район вила-реал-де-санту-антониу	Vila_Real_de_Santo_António_(parish)
вильягонсало-педерналес	Villagonzalo_Pedernales
ахалцихе	Akhaltsikhe
ако	Akō,_Hyōgo
банджар,индонезия	Banjar,_West_Java
аба	Aba,_Abia
врбовско	Vrbovsko
антиполо	Antipolo
атеа,сарагоса	Atea,_Zaragoza
бихуэска	Bijuesca
баку	Baku
бушир	Bushehr
арсуа	Arzúa
аштиан	Ashtian
вадильо-де-ла-сьерра	Vadillo_de_la_Sierra
вальюэрканес	Valluércanes
альберта,город	Alberta,_Minnesota
алтура,город	Altura,_Minnesota
виллимпента	Villimpenta
боярка	Boyarka
бучач	Buchach
барбарано-вичентино	Barbarano_Vicentino
вэньчан,город	Wenchang
алатырь	Alatyr,_Chuvash_Republic
бассет,небраска	Bassett,_Nebraska
виктория-де-дуранго	Durango,_Durango
асеред	Acered
виско	Visco,_Friuli
брукс,город	Brooks,_Minnesota
агрополи	Agropoli
акшак	Akshak
вергато	Vergato
буй,город	Buy,_Kostroma_Oblast
арлуно	Arluno
викторсберг	Viktorsberg
вега-де-инфансонес	Vega_de_Infanzones
арсье	Arsiè
барфлёр	Barfleur
адаб,город	Adab_(city)
алькориса	Alcorisa
авильяна	Avigliana
вальфлориана	Valfloriana
беллозгуардо	Bellosguardo
аликун-де-ортега	Alicún_de_Ortega
боара-пизани	Boara_Pisani
берголо	Bergolo
буксар,город	Buxar
баньо-а-риполи	Bagno_a_Ripoli
варберг,швеция	Varberg
алексин,город	Aleksin
брайтон,колорадо	Brighton,_Colorado
бейкерсфилд,калифорния	Bakersfield,_California
альтурас	Alturas,_California
бойд,миннесота	Boyd,_Minnesota
бургос	Burgos,_Sardinia
аккуаформоза	Acquaformosa
вильяумбралес	Villaumbrales
виллановафранка	Villanovafranca
вецселпилс	Sēlpils
визоне	Visone
воттиньяско	Vottignasco
верушув	Wieruszów
арканзас-сити	Arkansas_City,_Arkansas
варезе-лигуре	Varese_Ligure
вильяльба-де-лос-баррос	Villalba_de_los_Barros
вецца-д’ольо	Vezza_d'Oglio
астория,орегон	Astoria,_Oregon
воббия	Vobbia
вышгород	Vyshhorod
вартманнштеттен	Wartmannstetten
биннинген	Binningen,_Switzerland
адилабад	Adilabad
венафро	Venafro
бессемер	Bessemer,_Alabama
блайт,калифорния	Blythe,_California
анциранана	Antsiranana
вольсинии	Volsinii
весьегонск	Vesyegonsk
брахам	Braham,_Minnesota
аццио	Azzio
вийтасаари	Viitasaari
белгород	Belgorod
варпалота	Várpalota
валле-сан-николао	Valle_San_Nicolao
вали-ди-камбра	Vale_de_Cambra
аллахабад	Allahabad
аморгос	Amorgos
айлано	Ailano
бивертон	Beaverton,_Oregon
блу-эрт	Blue_Earth,_Minnesota
бояново	Bojanowo
вентотене,город	Ventotene
верхняя салда	Verkhnyaya_Salda
вивель-дель-рио-мартин	Vivel_del_Río_Martín
боно	Bono,_Italy
алмазная	Almazna
вилланова-дель-силларо	Villanova_del_Sillaro
виллетте	Villette,_Piedmont
берислав	Beryslav
виница	Vinica,_Macedonia
асила	Asilah
буйнакск	Buynaksk
бельвис-де-ла-хара	Belvís_de_la_Jara
брейнерд,миннесота	Brainerd,_Minnesota
вальдастильяс	Valdastillas
бирдсли,город	Beardsley,_Minnesota
альмочуэль	Almochuel
брандис-над-орлици	Brandýs_nad_Orlicí
андрыхув	Andrychów
аньон-де-монкайо	Añón_de_Moncayo
вайкинг,город	Viking,_Minnesota
бурса,город	Bursa
ашано	Asciano
алтура,миннесота	Altura,_Minnesota
аккра	Accra
барбадильо-де-эррерос	Barbadillo_de_Herreros
вайкинг	Viking,_Minnesota
ава,япония	Awa,_Tokushima
арджента	Argenta,_Emilia–Romagna
бонифати	Bonifati
бреццо-ди-бедеро	Brezzo_di_Bedero
бовалино	Bovalino
бальбоа	Balboa,_León
вайдхофен-ан-дер-тайя	Waidhofen_an_der_Thaya
альбидона	Albidona
бизачча	Bisaccia
бойссано	Boissano
бакингхем,квебек	Buckingham,_Quebec
ванг,нижняя австрия	Wang,_Austria
беллино	Bellino
бей-сити	Bay_City,_Michigan
библ	Byblos
бовеньо	Bovegno
вилладоссола	Villadossola
вальфенера	Valfenera
вильямартин-де-кампос	Villamartín_de_Campos
вайдор,техас	Vidor,_Texas
ариялур	Ariyalur
бхаджана-кутир	Bhajana_Kutir
блафтон,миннесота	Bluffton,_Minnesota
адрада-де-аса	Adrada_de_Haza
венгожево	Węgorzewo
арборея	Arborea
анурадхапура	Anuradhapura
белл-плейн,миннесота	Belle_Plaine,_Minnesota
бенешов	Benešov
бенна	Benna,_Piedmont
бриджтаун	Bridgetown
акаси	Akashi,_Hyōgo
бина	Bena,_Minnesota
вилланова-ди-кампосампьеро	Villanova_di_Camposampiero
арона,италия	Arona,_Piedmont
алькончель-де-ариса	Alconchel_de_Ariza
врабле	Vráble
валлио-терме	Vallio_Terme
валье-де-вальделусио	Valle_de_Valdelucio
вельки-кртиш	Veľký_Krtíš
вишнупур,город	Bishnupur,_Bankura
валга	Valga,_Estonia
вильяррамьель	Villarramiel
вильхельмсбург	Wilhelmsburg,_Austria
велюнь,польша	Wieluń
бузаки	Busachi
бибербах	Biberbach,_Austria
амендолара	Amendolara
валье-де-седано	Valle_de_Sedano
антродоко	Antrodoco
аинса-собрарбе	Aínsa-Sobrarbe
альтаре	Altare
альберт-ли	Albert_Lea,_Minnesota
аттапы	Attapeu
брессанвидо	Bressanvido
анаконда,монтана	Anaconda,_Montana
ардезьо	Ardesio
вероленго	Verolengo
биджар	Bijar
бишо	Bhisho
бистаньо	Bistagno
вальстанья	Valstagna
бароло,город	Barolo,_Piedmont
бивонджи	Bivongi
виньоне	Vignone
арона	Arona,_Piedmont
булонь-сюр-мер	Boulogne-sur-Mer
бутурлиновка	Buturlinovka
альпухарра-де-ла-сьерра	Alpujarra_de_la_Sierra
вернберг	Wernberg
барки,италия	Barchi,_Marche
аннаберг,австрия	Annaberg,_Lower_Austria
асаба	Asaba,_Delta
виборг,город	Viborg,_Denmark
баньон	Bañón
баллао	Ballao
багалади	Bagaladi
ваднес-хайтс,миннесота	Vadnais_Heights,_Minnesota
абботсфорд,британская колумбия	Abbotsford,_British_Columbia
аньозине	Agnosine
бернсвилл,миннесота	Burnsville,_Minnesota
боргоратто-мормороло	Borgoratto_Mormorolo
вонджу	Wonju
бедиас,техас	Bedias,_Texas
болохово	Bolokhovo
бой-ривер	Boy_River,_Minnesota
восточный берлин	East_Berlin
вильясила-де-вальдавия	Villasila_de_Valdavia
вигодарцере	Vigodarzere
валенца	Valenza
бускистар	Busquístar
вайсенштайн	Weißenstein
бюрегаван	Byureghavan
бад-хофгастайн	Bad_Hofgastein
вигонца	Vigonza
бхаратпур,индия	Bharatpur,_Rajasthan
бавено	Baveno
виагранде	Viagrande
бурхание	Burhaniye
алекнагик,аляска	Aleknagik,_Alaska
аира,город	Aira,_Kagoshima_(Aira)
варняй	Varniai
аруша	Arusha
боубеллс,дакота	Bowbells,_North_Dakota
бранч,арканзас	Branch,_Arkansas
вилланова-дель-баттиста	Villanova_del_Battista
боулус,город	Bowlus,_Minnesota
бок,город	Bock,_Minnesota
аулетта	Auletta
буссоленго	Bussolengo
вернамхваст	Varnamkhast
бородино,город	Borodino,_Krasnoyarsk_Krai
альгаринехо	Algarinejo
вольпара	Volpara
брэила	Brăila
баярдо	Bajardo
ателета	Ateleta
бороградек	Borohrádek
банари	Banari
алхамбра,калифорния	Alhambra,_California
белицкое	Bilytske
водице	Vodice,_Croatia
астреа	Astrea,_Cesar
вилла-вичентина	Villa_Vicentina
байджи	Baiji,_Iraq
бирюч	Biryuch
алтура	Altura,_Minnesota
альба,пьемонт	Alba,_Piedmont
антигуэдад	Antigüedad
болонья	Bologna
березань	Berezan
бишофсцелль	Bischofszell
бигфорк,миннесота	Bigfork,_Minnesota
коммуна белла	Bella,_Basilicata
асеманабад	Asemanabad
брайтенбрунн-ам-нойзидлер-зе	Breitenbrunn,_Austria
бьютт	Butte,_Montana
брасуэло	Brazuelo
вайксельбаум,бургенланд	Weichselbaum
боккильеро	Bocchigliero
америка	América,_Tamaulipas
бырлад	Bârlad
баттерфилд,миннесота	Butterfield,_Minnesota
верделло	Verdello
бицзе	Bijie
аттильяно	Attigliano
асайла	Azaila
бариле	Barile
безано	Besano
азуни,сардиния	Asuni
варалло-помбия	Varallo_Pombia
вашковцы,район	Vashkivtsi
байрон	Byron,_Minnesota
верещагино	Vereshchagino,_Vereshchaginsky_District,_Perm_Krai
веделаго	Vedelago
вудсток,миннесота	Woodstock,_Minnesota
виллафранка-д’асти	Villafranca_d'Asti
балесар	Balesar
агно	Haguenau
бакерин-де-кампос	Baquerín_de_Campos
артёмовка,полтавская область	Artemivka
бжостек	Brzostek
вязьма	Vyazma
альмодовар-дель-кампо	Almodóvar_del_Campo
валье-де-тобалина	Valle_de_Tobalina
вадовице	Wadowice
вилла-ди-бриано	Villa_di_Briano
анбарабад	Anbarabad
бугуджате	Buguggiate
алитус	Alytus
вильякиран-де-лос-инфантес	Villaquirán_de_los_Infantes
вильяр-дель-сальс	Villar_del_Salz
аффиле	Affile
боадилья-дель-камино	Boadilla_del_Camino
вильярродриго	Villarrodrigo
барете	Barete
бельведере-остренсе	Belvedere_Ostrense
брабос	Brabos
агилар-дель-альфамбра	Aguilar_del_Alfambra
биски,город	Biscay,_Minnesota
ангуэс	Angüés
авиз	Avise
армеро,колумбия	Armero
бустильо-дель-парамо-де-каррион	Bustillo_del_Páramo_de_Carrión
акуре	Akure
амбон,город	Ambon,_Maluku
абахас	Abajas
вальва	Valva,_Campania
вильяльба-де-перехиль	Villalba_de_Perejil
баймак	Baymak
арнезано	Arnesano
бернеццо	Bernezzo
ботошани	Botoșani
войцешув	Wojcieszów
бусси-суль-тирино	Bussi_sul_Tirino
бишелье	Bisceglie
берутув	Bierutów
афула	Afula
ашленд	Ashland,_Ohio
вареш	Vareš
амами	Amami,_Kagoshima
альбалате-дель-арсобиспо	Albalate_del_Arzobispo
альтенмаркт-им-понгау	Altenmarkt_im_Pongau
амфиполис	Amphipolis
боада-де-кампос	Boada_de_Campos
вайонт	Vajont
аусерфильгратен	Außervillgraten
айдомаджоре	Aidomaggiore
вудберн	Woodburn,_Oregon
арта-терме	Arta_Terme
бертиоло	Bertiolo
аргостолион	Argostoli
андовер,миннесота	Andover,_Minnesota
ардаули	Ardauli
айония	Ionia,_Michigan
абовян	Abovyan
барстоу	Barstow,_California
борго-приоло	Borgo_Priolo
белозерск	Belozersk
вадо-лигуре	Vado_Ligure
вильятобас	Villatobas
ачеренца	Acerenza
вилла-ди-тирано	Villa_di_Tirano
бондено	Bondeno
апеккьо	Apecchio
аполлоза	Apollosa
белхатув	Bełchatów
брандон,миннесота	Brandon,_Minnesota
валсад	Valsad
абпахш	Ab_Pakhsh
агуас-кандидас	Aguas_Cándidas
альтштеттен,санкт-галлен	Altstätten
альтштеттен	Altstätten
воднян	Vodnjan
белл-плейн	Belle_Plaine,_Minnesota
валле-ди-кадоре	Valle_di_Cadore
вальдевердеха	Valdeverdeja
вишков	Vyškov
альбано-ди-лукания	Albano_di_Lucania
валлепьетра	Vallepietra
артур	Arthur,_Iowa
ардоре	Ardore
абертами	Abertamy
балканабат	Balkanabat
абзам	Absam
амакуса,город	Amakusa,_Kumamoto
атесса	Atessa
аксай	Aksay,_Rostov_Oblast
алонг	Along,_Arunachal_Pradesh
абингдон,иллинойс	Abingdon,_Illinois
виллануова-суль-клизи	Villanuova_sul_Clisi
абрантиш	Abrantes
арцергранде	Arzergrande
вильяэрмоса-дель-кампо	Villahermosa_del_Campo
брок	Brok
ваццола	Vazzola
вэйфан	Weifang
березники	Berezniki
бусовача	Busovača
баджна	Bajna,_India
бопфинген	Bopfingen
бенетутти	Benetutti
бандар-лампунг	Bandar_Lampung
англтон	Angleton,_Texas
барберино-ди-муджелло	Barberino_di_Mugello
бурухон	Burujón
вильяеррерос	Villaherreros
амбуситра	Ambositra
бернсвилл	Burnsville,_Minnesota
вильериас-де-кампос	Villerías_de_Campos
виган	Vigan
виу	Viù
вуд-лейк	Wood_Lake,_Minnesota
вилла-сант-анджело	Villa_Sant'Angelo
вильегас	Villegas
биски	Biscay,_Minnesota
арсе	Arce
берген	Bergen
бастия-умбра	Bastia_Umbra
вальданьо	Valdagno
варта	Warta,_Poland
бентон,арканзас	Benton,_Arkansas
вильямьель	Villamiel
аиджал	Aizawl
балнеариу-камбориу	Balneário_Camboriú
будрио	Budrio
вилланова-туло	Villanova_Tulo
боббио-пелличе	Bobbio_Pellice
вилья-дель-рей	Villa_del_Rey
вильясекилья	Villasequilla
виттуоне	Vittuone
вильямедьяна	Villamediana
бергерн-им-дункельштайнервальд	Bergern_im_Dunkelsteinerwald
акисима	Akishima,_Tokyo
бронделло	Brondello
бема	Bema,_Lombardy
батангас	Batangas_City
альмехихар	Almegíjar
армидейл	Armidale,_New_South_Wales
вилла-сан-джованни	Villa_San_Giovanni
алавус	Alavus
вайнбург,австрия	Weinburg
бирори	Birori
бургшлайниц-кюнринг	Burgschleinitz-Kühnring
баранелло	Baranello
биджу,город	Bejou,_Minnesota
бахмач	Bakhmach
ванг,австрия	Wang,_Austria
арандилья	Arandilla
барранкабермеха	Barrancabermeja
вафандянь	Wafangdian
альма,арканзас	Alma,_Arkansas
алвар	Alwar
валья,италия	Vaglia
балашиха	Balashikha
амелия	Amelia,_Umbria
вильясансо-де-вальдерадуэй	Villazanzo_de_Valderaduey
асахи	Asahi,_Chiba
америка,тамаулипас	América,_Tamaulipas
ветлуга,город	Vetluga
вальдеункар	Valdehúncar
вильясопеке	Villazopeque
альбрехтсберг-ан-дер-гросен-кремс	Albrechtsberg_an_der_Großen_Krems
алверка-ду-рибатежу	Alverca_do_Ribatejo
адро	Adro
аргуэлло	Arguello
вейс,хузестан	Veys
верндейл,миннесота	Verndale,_Minnesota
бедмар-и-гарсиэс	Bedmar_y_Garcíez
вильямуэра-де-ла-куэса	Villamuera_de_la_Cueza
весковато,италия	Vescovato,_Lombardy
буэнос-айрес	Buenos_Aires
ариано-ирпино	Ariano_Irpino
ванн	Vannes
анцано-дель-парко	Anzano_del_Parco
барле-нассау	Baarle-Nassau
амурск	Amursk
арнара	Arnara
бедиани	Bediani
бржецлав	Břeclav
биканер	Bikaner
барстоу,калифорния	Barstow,_California
бедре	Badreh
бели-манастир	Beli_Manastir
буттильера-альта	Buttigliera_Alta
альтхофен	Althofen
батерст,австралия	Bathurst,_New_South_Wales
билибино	Bilibino
алупка	Alupka
альгарробо,колумбия	Algarrobo,_Magdalena
астара,иран	Astara,_Iran
барбона	Barbona
вольнянск	Vilniansk
бакэу	Bacău
алькампель	Alcampell
алагон	Alagón,_Zaragoza
августов	Augustów
баньореджо	Bagnoregio
басра	Basra
беллуско	Bellusco
бломкест,миннесота	Blomkest,_Minnesota
баффало-лейк,город	Buffalo_Lake,_Minnesota
богодухов	Bohodukhiv
банияс	Banias
бад-пираварт	Bad_Pirawarth
бендер-риг	Bandar_Rig
авадзи	Awaji,_Hyōgo
вальдельтормо	Valdeltormo
беллинцона	Bellinzona
видеркер-вилидж	Wiederkehr_Village,_Arkansas
барбуньялес	Barbuñales
арбус	Arbus,_Sardinia
боффалора-д’адда	Boffalora_d'Adda
алекнагик	Aleknagik,_Alaska
боццоло	Bozzolo
боченаго	Bocenago
асков,город	Askov,_Minnesota
брайант	Bryant,_Arkansas
вергерето	Verghereto
ванген-на-аре	Wangen_an_der_Aare
боксдорф	Bocksdorf
болдуин-парк,калифорния	Baldwin_Park,_California
браунсдейл,миннесота	Brownsdale,_Minnesota
асбест	Asbest
вальвазоне	Valvasone
аладрен	Aladrén
абриола	Abriola
валлерано	Vallerano
виллупурам	Viluppuram
виверо	Viveiro
бондоне	Bondone
веллуру	Vellore
бакуриани	Bakuriani
бельмонте-ин-сабина	Belmonte_in_Sabina
великий новгород	Veliky_Novgorod
вилла-базилика	Villa_Basilica
бекаси	Bekasi
аркильос	Arquillos
ампеццо	Ampezzo
арена,калабрия	Arena,_Calabria
барроу	Barrow,_Alaska
винсхотен	Winschoten
вильянуэва-де-ла-серена	Villanueva_de_la_Serena
ардон	Ardón
алкобаса,город	Alcobaça,_Portugal
бейнбридж,джорджия	Bainbridge,_Georgia
вальденбург,базель-ланд	Waldenburg,_Switzerland
асакура,город	Asakura,_Fukuoka
айхграбен	Eichgraben
апелдорн	Apeldoorn
антонимина	Antonimina
веддаска	Veddasca
браньосера	Brañosera
вахрушево	Vakhrusheve
вайтра	Weitra
бернсвилл,город	Burnsville,_Minnesota
восход,область	Voskhod,_Moscow_Oblast
бад,иран	Badrud
боццоле	Bozzole
бадарийская культура	Badari_culture
аркадак	Arkadak
беверли-хиллз	Beverly_Hills,_California
базико	Basicò
вильянди	Viljandi
альтхайм,австрия	Altheim,_Austria
батл-лейк,город	Battle_Lake,_Minnesota
бейт-сахур	Beit_Sahour
барановка	Baranivka_(city)
айос-николаос,крит	Agios_Nikolaos,_Crete
белфаст	Belfast
вяземский,город	Vyazemsky,_Khabarovsk_Krai
бендер-гез	Bandar-e_Gaz
арао	Arao,_Kumamoto
артёмовка	Artemivka
варедо	Varedo
веденсвиль	Wädenswil
баресса	Baressa
аппер-калскаг	Upper_Kalskag,_Alaska
вараждин	Varaždin
белово	Belovo,_Kemerovo_Oblast
вальдепеньяс-де-хаэн	Valdepeñas_de_Jaén
альманса,леон	Almanza
брайтенау	Breitenau,_Lower_Austria
аркуньяно	Arcugnano
бертонико	Bertonico
бизенти	Bisenti
брессо	Bresso
брейди,техас	Brady,_Texas
витторио-венето	Vittorio_Veneto
вилла-ди-кьявенна	Villa_di_Chiavenna
вильянуэва-дель-рей	Villanueva_del_Rey
амарилло	Amarillo,_Texas
альбанелла	Albanella
альмоаха	Almohaja
болькув	Bolków
вилла-литерно	Villa_Literno
алатос	Alatoz
брезно	Brezno
банкетте	Banchette
агарти	Agartha
вальдевимбре	Valdevimbre
вашковцы,вижницкий район	Vashkivtsi
борек-велькопольский	Borek_Wielkopolski
барлинек	Barlinek
вальтице	Valtice
авока,город	Avoca,_Minnesota
боно,сардиния	Bono,_Italy
виллафранка-тиррена	Villafranca_Tirrena
алигарх	Aligarh,_Uttar_Pradesh
андовер,город	Andover,_Minnesota
ахтала	Akhtala
ашби	Ashby,_Minnesota
амблар	Amblar
ама	Ama,_Aichi
брейди	Brady,_Texas
бельмонте-де-грасьян	Belmonte_de_Gracián
альцате-брианца	Alzate_Brianza
вишакхапатнам	Visakhapatnam
вьетри-ди-потенца	Vietri_di_Potenza
амеюго	Ameyugo
айгостена	Aigosthena
буска	Busca
бальдикьери-д’асти	Baldichieri_d'Asti
бильдайн	Bildein
винкларн,австрия	Winklarn,_Austria
биллингс,монтана	Billings,_Montana
балхаш	Balkhash_(city)
вильярьесо	Villariezo
бодетт	Baudette,_Minnesota
бодрум	Bodrum
брионе,провинция	Brione,_Trentino
борго-маджоре	Borgo_Maggiore
арта	Arta,_Greece
вижница	Vyzhnytsia
великие луки	Velikiye_Luki
вигоне	Vigone
бальцола	Balzola
боволента	Bovolenta
бреме,италия	Breme
аррая-де-ока	Arraya_de_Oca
баренго	Barengo
бичиникко	Bicinicco
веццано-суль-кростоло	Vezzano_sul_Crostolo
баллия	Ballia
берг,нижняя австрия	Berg,_Lower_Austria
алхамбра	Alhambra,_California
болотана	Bolotana
венаус	Venaus
акино	Aquino
вольвера	Volvera
вилластеллоне	Villastellone
вальверде-энрике	Valverde-Enrique
вальденштайн	Waldenstein
больтанья	Boltaña
басго	Basgo
бремерхафен	Bremerhaven
бокиньени	Boquiñeni
алессано	Alessano
бруклин-парк,город	Brooklyn_Park,_Minnesota
альбек	Albeck,_Carinthia
атлантида	Atlantis
бестек	Bastak
вальдеольмильос	Valdeolmillos
арба,город	Arba,_Friuli-Venezia_Giulia
валлелунга-пратамено	Vallelunga_Pratameno
аниак,аляска	Aniak,_Alaska
барбьянелло	Barbianello
альмодовар-дель-рио	Almodóvar_del_Río
боскотреказе	Boscotrecase
андало	Andalo
белозёрское	Bilozerske
бельфорте-аль-изауро	Belforte_all'Isauro
адауэска	Adahuesca
асин	Asín,_Aragon
велайос	Velayos
баоне	Baone
абха	Abha
альбаредо-пер-сан-марко	Albaredo_per_San_Marco
бруклин-парк	Brooklyn_Park,_Minnesota
ворожба	Vorozhba
бад-бухау	Bad_Buchau
валье-де-санта-ана	Valle_de_Santa_Ana
анталья	Antalya
вилла-дель-боско	Villa_del_Bosco
вауда-канавезе	Vauda_Canavese
аличе-бель-колле	Alice_Bel_Colle
бейт-шемеш	Beit_Shemesh
арцакена,сардиния	Arzachena
виксберг	Vicksburg,_Mississippi
буско-здруй	Busko-Zdrój
аксай,область	Aksay,_Rostov_Oblast
аскона	Ascona
вега-де-валькарсе	Vega_de_Valcarce
балашов	Balashov_(town)
анкона	Ancona
альберо-бахо	Albero_Bajo
антилло	Antillo
версаль	Versailles,_Missouri
аббер	Ab_Bar
вильярехо-де-монтальбан	Villarejo_de_Montalbán
болхов	Bolkhov
ава,город	Awa,_Tokushima
вильянуэва-де-гальего	Villanueva_de_Gállego
аба,город	Aba,_Abia
вильяфранка-монтес-де-ока	Villafranca_Montes_de_Oca
бхинга	Bhinga
бодайбо	Bodaybo
валло-делла-лукания	Vallo_della_Lucania
вудленд,миннесота	Woodland,_Minnesota
аслинг,тироль	Assling
бедфорд	Bedford,_Virginia
батрун	Batroun
вольпьяно	Volpiano
валлекрозия	Vallecrosia
баумгартен,бургенланд	Baumgarten,_Burgenland
андервуд	Underwood,_Minnesota
виго-ди-кадоре	Vigo_di_Cadore
боргетто-санто-спирито	Borghetto_Santo_Spirito
аруша,город	Arusha
агилон	Aguilón
аллентаун	Allentown,_Pennsylvania
атценбруг	Atzenbrugg
арциньяно	Arzignano
баронисси	Baronissi
арсеньев	Arsenyev
бруджине	Brugine
ачи-бонаккорси	Aci_Bonaccorsi
вальдоррос	Valdorros
барранкас	Barrancas,_La_Guajira
банджармасин	Banjarmasin
бучине	Bucine
батхинда	Bathinda
виллар-дора	Villar_Dora
аланхе	Alange
биатрис,небраска	Beatrice,_Nebraska
атрани	Atrani
вилланова-монтелеоне	Villanova_Monteleone
бежецк	Bezhetsk
веджано	Veggiano
васлуй	Vaslui
абакалики	Abakaliki
анадон	Anadón
баяно	Baiano,_Campania
брокен-боу	Broken_Bow,_Nebraska
вислуни	Výsluní
баштанка	Bashtanka
актау	Aktau
берли	Burley,_Idaho
бисби,аризона	Bisbee,_Arizona
бальмучча	Balmuccia
альмендраль	Almendral
брест,франция	Brest,_France
билгорай	Biłgoraj
арбург	Aarburg
агуас-морнас	Águas_Mornas
брутен,город	Brooten,_Minnesota
вилланова-соларо	Villanova_Solaro
айзенштадт	Eisenstadt
аппенцелль,город	Appenzell_(town)
альфорке	Alforque
бонгайгаон	Bongaigaon
верджате	Vergiate
аварис	Avaris
викальви	Vicalvi
брокен-эрроу	Broken_Arrow,_Oklahoma
вольфсбург	Wolfsburg
аппенцелль	Appenzell_(town)
банкура	Bankura
виллапутцу	Villaputzu
вильянуэва-де-хилока	Villanueva_de_Jiloca
априльяно	Aprigliano
вальсольда	Valsolda
берсияль-де-сапардьель	Bercial_de_Zapardiel
атами	Atami,_Shizuoka
альмонасид-де-толедо	Almonacid_de_Toledo
бид,город	Beed
братунац	Bratunac
вико-экуэнсе	Vico_Equense
башано	Basciano
берн	Bern
асикага	Ashikaga,_Tochigi
альдено	Aldeno
вальверде-де-леганес	Valverde_de_Leganés
бокейхон	Boqueixón
бяла-равска	Biała_Rawska
аккуавива-коллекроче	Acquaviva_Collecroce
алькаудете-де-ла-хара	Alcaudete_de_la_Jara
верджиния	Virginia,_Minnesota
альфьяно-натта	Alfiano_Natta
боско-кьезануова	Bosco_Chiesanuova
будзен	Buzen,_Fukuoka
ауаса,город	Awasa
анела	Anela
виллар-пелличе	Villar_Pellice
вильярроя-дель-кампо	Villarroya_del_Campo
асадабад,хамадан	Asadabad,_Iran
банда-ачех	Banda_Aceh
бяла	Biała_Prudnicka
вальдекуэнка	Valdecuenca
бранево	Braniewo
бордхун	Bord_Khun
аден	Aden
вальбуэна-де-писуэрга	Valbuena_de_Pisuerga
ама,город	Ama,_Aichi
блуденц	Bludenz
вильямандос	Villamandos
варесе	Varese
вронки	Wronki
бюрен	Buren
беттиах	Bettiah
вилланова-бьеллезе	Villanova_Biellese
валлермоза	Vallermosa
веста	Vesta,_Minnesota
бук	Buk
борджа	Borgia,_Calabria
брно	Brno
арколе	Arcole
виново	Vinovo
битонто	Bitonto
берсоса-де-буреба	Berzosa_de_Bureba
альбания,гуахира	Albania,_La_Guajira
акируно	Akiruno,_Tokyo
бризи-пойнт	Breezy_Point,_Minnesota
вардзиа	Vardzia
борба	Borba,_Portugal
бардеёв	Bardejov
айзоне	Aisone
адак,аляска	Adak,_Alaska
верона	Verona
баньяра-ди-романья	Bagnara_di_Romagna
альдеануэва-дель-камино	Aldeanueva_del_Camino
базилиано	Basiliano
вильгельмсхафен	Wilhelmshaven
бендзин	Będzin
валлада-агордина	Vallada_Agordina
антакья	Antakya
апамея	Apamea,_Syria
аета	Aieta
антрона-скьеранко	Antrona_Schieranco
венегоно-инфериоре	Venegono_Inferiore
бормухос	Bormujos
вильякиран-де-ла-пуэбла	Villaquirán_de_la_Puebla
виске	Vische
вевак	Wewak
блоне,польша	Błonie
буин,иран	Buin_Zahra
асналькольяр	Aznalcóllar
бентон	Benton,_Arkansas
борне-сулиново	Borne_Sulinowo
безенелло	Besenello
амажари	Amajari
бейджесултан	Beycesultan
бродница,куявско-поморское воеводство	Brodnica
коммуна вельо	Veglio
айронтон,миннесота	Ironton,_Minnesota
виддальба	Viddalba
вальбревенна	Valbrevenna
альфантега	Alfántega
вильяфранка-де-ла-сьерра	Villafranca_de_la_Sierra
альмалуэс	Almaluez
айнет	Ainet
беллинцаго-новарезе	Bellinzago_Novarese
баудх	Boudh
бялы-бур	Biały_Bór
берберана	Berberana
вальторрес	Valtorres
бербегаль	Berbegal
брегуццо	Breguzzo
бридж-сити,техас	Bridge_City,_Texas
анантнаг	Anantnag
асинас	Hacinas
боргомале	Borgomale
вжесня	Września
беллона,кампания	Bellona,_Campania
адана	Adana
абарка-де-кампос	Abarca_de_Campos
блейн,город	Blaine,_Minnesota
брачильяно	Bracigliano
бендер-торкеман	Bandar_Torkaman
аритцо	Aritzo
баголино	Bagolino
базалуццо	Basaluzzo
вольфсбах	Wolfsbach
альмуния-де-сан-хуан	Almunia_de_San_Juan
баньоло-дель-саленто	Bagnolo_del_Salento
армено	Armeno
бельмонте-кастелло	Belmonte_Castello
бехараншехр	Baharan_Shahr
бовилле-эрника	Boville_Ernica
веста,город	Vesta,_Minnesota
аксай,ростовская область	Aksay,_Rostov_Oblast
баньярия-арса	Bagnaria_Arsa
валь-де-сан-лоренсо	Val_de_San_Lorenzo
бабольсер	Babolsar
бомарцо	Bomarzo
бейонн	Bayonne,_New_Jersey
вимпассинг-на-лайте	Wimpassing_an_der_Leitha
бинетто	Binetto
бершадь	Bershad
вулькапродерсдорф	Wulkaprodersdorf
арна	Arnad
алессандрия	Alessandria
абсдорф	Absdorf
амарони	Amaroni
вильяфруэла	Villafruela
багена	Báguena
айона,город	Iona,_Minnesota
виллальфонсина	Villalfonsina
аликанте	Alicante
бивер-крик,миннесота	Beaver_Creek,_Minnesota
акко	Acre,_Israel
вентура,калифорния	Ventura,_California
вальехо,калифорния	Vallejo,_California
бычина	Byczyna
анан	Anan,_Tokushima
анцано-ди-пулья	Anzano_di_Puglia
баоцзи	Baoji
венария-реале	Venaria_Reale
вернал,юта	Vernal,_Utah
буя	Buja
арройо-де-сан-серван	Arroyo_de_San_Serván
арария	Araria
вентас-де-уэльма	Ventas_de_Huelma
аренцано	Arenzano
волоколамск	Volokolamsk
борголаведзаро	Borgolavezzaro
всхова	Wschowa
бромон	Bromont,_Quebec
варка,город	Warka
агроландия	Agrolândia
анауак	Anahuac,_Texas
виньяте	Vignate
вуд-лейк,город	Wood_Lake,_Minnesota
ангерн-ан-дер-марх	Angern_an_der_March
виллар-пероза	Villar_Perosa
берцо-демо	Berzo_Demo
бендиго	Bendigo
аверса	Aversa
вейпрти	Vejprty
борно	Borno,_Lombardy
вилла-коллемандина	Villa_Collemandina
боргосезия	Borgosesia
альпетте	Alpette
белгород-днестровский	Bilhorod-Dnistrovskyi
бологое	Bologoye
аньшунь	Anshun
батурин	Baturyn
абаша	Abasha
блашки	Błaszki
вильярехо-де-орбиго	Villarejo_de_Órbigo
бриуэга	Brihuega
бхавнагар	Bhavnagar
айлоке	Ailoche
буссето	Busseto
альтомонте	Altomonte
бингхем-лейк,миннесота	Bingham_Lake,_Minnesota
бинефар	Binéfar
вильяда	Villada
ардзене	Arzene
вилламанья	Villamagna
вардё	Vardø
бхилаи	Bhilai
владыславово	Władysławowo
бейнаско	Beinasco
баньо-ди-романья	Bagno_di_Romagna
агуачика	Aguachica
бьеловар	Bjelovar
андора	Andora
виньяле-монферрато	Vignale_Monferrato
базель	Basel
арриах	Arriach
вергас,город	Vergas,_Minnesota
брахам,город	Braham,_Minnesota
арпино	Arpino
врангель	Wrangell,_Alaska
асия	Ashiya,_Hyōgo
барри	Barry,_Minnesota
коммуна бьянки	Bianchi,_Calabria
абия-де-лас-торрес	Abia_de_las_Torres
аксу	Aksu,_Kazakhstan
алецио	Alezio
вильферсдорф,австрия	Wilfersdorf
берд-айленд,миннесота	Bird_Island,_Minnesota
бруклин-сентер,город	Brooklyn_Center,_Minnesota
аренас-де-сан-педро	Arenas_de_San_Pedro
валенса,португалия	Valença,_Portugal
боруп,миннесота	Borup,_Minnesota
вайдхофен-ан-дер-ибс	Waidhofen_an_der_Ybbs
бинаго	Binago
боргетто-ди-борбера	Borghetto_di_Borbera
вильянуэва-де-ароса	Vilanova_de_Arousa
виго-ди-фасса	Vigo_di_Fassa
астория	Astoria,_Oregon
альцано-скривия	Alzano_Scrivia
вотупоранга	Votuporanga
берунь	Bieruń
афьон-карахисар	Afyonkarahisar
анока,город	Anoka,_Minnesota
биг-тимбер	Big_Timber,_Montana
бузулук	Buzuluk
вильялькасар-де-сирга	Villalcázar_de_Sirga
бжеско	Brzesko
аларба	Alarba
барпета	Barpeta
асо,город	Aso,_Kumamoto
велилья-де-хилока	Velilla_de_Jiloca
балчик	Balchik
вальденго	Valdengo
арден-хилс,город	Arden_Hills,_Minnesota
бекер	Becker,_Minnesota
батерно	Baterno
брукс,миннесота	Brooks,_Minnesota
боруджен	Borujen
вьяриджи	Viarigi
веррей	Verrayes
бирдженд	Birjand
волхов,город	Volkhov
белл	Bell,_California
виллагранде-стризайли	Villagrande_Strisaili
анноне-венето	Annone_Veneto
банбери,австралия	Bunbury,_Western_Australia
априка	Aprica
ванцаго	Vanzago
ваксхольм	Vaxholm
алтеймер,арканзас	Altheimer,_Arkansas
винкларн,нижняя австрия	Winklarn,_Austria
буббьяно	Bubbiano
бирюч,город	Biryuch
ванье,оттава	Vanier,_Ontario
бертрум,город	Burtrum,_Minnesota
бока,город	Boca,_Novara
барановка,город	Baranivka_(city)
бурон,леон	Burón
вальмонтоне	Valmontone
врутки	Vrútky
агринион	Agrinio
бене-ваджиенна	Bene_Vagienna
бока-ратон,флорида	Boca_Raton,_Florida
альберт-ли,город	Albert_Lea,_Minnesota
вилла-сан-пьетро	Villa_San_Pietro
бадгастайн	Bad_Gastein
беналуа-де-лас-вильяс	Benalúa_de_las_Villas
вернаска	Vernasca
версаль,миссури	Versailles,_Missouri
бенсон	Benson,_Minnesota
верндейл	Verndale,_Minnesota
валлефьорита	Vallefiorita
аллайанс	Alliance,_Nebraska
артём	Artyom,_Russia
атина	Atina,_Lazio
вальпальмас	Valpalmas
влень	Wleń
амаравати,индия	Amaravati,_Andhra_Pradesh
банджарбару	Banjarbaru
вилламирольо	Villamiroglio
виллароманьяно	Villaromagnano
вильянуэва	Villanueva,_La_Guajira
аркуата-скривия	Arquata_Scrivia
бродница,воеводство	Brodnica
ветлуга	Vetluga
броссаско	Brossasco
бетлехем,пенсильвания	Bethlehem,_Pennsylvania
боре,италия	Bore,_Emilia-Romagna
вильянуэва-дель-ребольяр	Villanueva_del_Rebollar
арконате	Arconate
батайск	Bataysk
баричелла	Baricella
винета	Vineta
баньяра-калабра	Bagnara_Calabra
валдоста	Valdosta,_Georgia
блайтвилл,арканзас	Blytheville,_Arkansas
бласкомильян	Blascomillán
альсерио	Alserio
вальдефресно	Valdefresno
амасра	Amasra
бикин	Bikin
бехбехан	Behbahan
вильясур-де-эррерос	Villasur_de_Herreros
альбозаджа	Albosaggia
богухвала	Boguchwała
батерст	Bathurst,_New_South_Wales
виллафранка-сикула	Villafranca_Sicula
бенгела,город	Benguela
белоярский,город	Beloyarsky,_Khanty-Mansi_Autonomous_Okrug
коммуна боволента	Bovolenta
бэйань	Bei'an
ангронья	Angrogna
вайнинг,миннесота	Vining,_Minnesota
альби	Albi,_Calabria
виджанелло	Viggianello
брото	Broto
верхотурье	Verkhoturye
баррейру	Barreiro_(city)
айсанти,город	Isanti,_Minnesota
борго-сан-дальмаццо	Borgo_San_Dalmazzo
амбон	Ambon,_Maluku
агрыз	Agryz
бруино	Bruino
борокс	Borox
алобрас	Alobras
баркабо	Bárcabo
аннополь	Annopol
вильямайор-де-тревиньо	Villamayor_de_Treviño
ателла	Atella,_Basilicata
виджу	Viggiù
ваттенберг	Wattenberg,_Tyrol
беллари	Bellary
вильяр-де-рена	Villar_de_Rena
виленья	Vileña
венгожино	Węgorzyno
адрия	Adria
вольсинии,этрурия	Volsinii
антиколи-коррадо	Anticoli_Corrado
волув	Wołów
бане,город	Baneh
ботани	Botany_Bay
вишнёвое,город	Vyshneve
акутан,аляска	Akutan,_Alaska
бовес	Boves
абаде-ташк	Abadeh_Tashk
абботсфорд,колумбия	Abbotsford,_British_Columbia
альдеуэла-де-херте	Aldehuela_de_Jerte
боулус,миннесота	Bowlus,_Minnesota
вильяфранка-де-кордова	Villafranca_de_Córdoba
брокен-хилл	Broken_Hill,_New_South_Wales
амаркантак	Amarkantak
балтойи-воке	Baltoji_Vokė
брум,австралия	Broome,_Western_Australia
бонтанг	Bontang
бахчисарай	Bakhchysarai
берхампур	Berhampur
белу-оризонти	Belo_Horizonte
бане	Baneh
ауэрсталь	Auersthal
балургхат	Balurghat
вадодара	Vadodara
бодьо-ломнаго	Bodio_Lomnago
виколунго	Vicolungo
вайнбург,нижняя австрия	Weinburg
баколи	Bacoli
авейнте	Aveinte
бласкосанчо	Blascosancho
брайтенфурт-бай-вин	Breitenfurt_bei_Wien
вальвестино	Valvestino
винклерн	Winklern
бановце-над-бебравоу	Bánovce_nad_Bebravou
вильянуэва-де-гомес	Villanueva_de_Gómez
боре	Bore,_Emilia-Romagna
ардиса	Ardisa
баррачина	Barrachina
баумгартен	Baumgarten,_Burgenland
брэдли,арканзас	Bradley,_Arkansas
вальброна	Valbrona
арёгала	Ariogala
бесерриль	Becerril
брея	Breia
вильябрас	Villabraz
боа-виста,рорайма	Boa_Vista,_Roraima
бойсе,город	Boise,_Idaho
булл-шолс	Bull_Shoals,_Arkansas
белоярский	Beloyarsky,_Khanty-Mansi_Autonomous_Okrug
айванхо	Ivanhoe,_Minnesota
амалиендорф-альфанг	Amaliendorf-Aalfang
валье-де-лоса	Valle_de_Losa
вилла-сан-джованни-ин-туша	Villa_San_Giovanni_in_Tuscia
абабух	Ababuj
авио	Avio,_Trentino
альсено	Alseno
вальделинарес	Valdelinares
вомбжезьно	Wąbrzeźno
вильямбистия	Villambistia
вильямалур	Villamalur
белишче	Belišće
амбель	Ambel
вильянуэва-дель-асераль	Villanueva_del_Aceral
альбиссола-марина	Albissola_Marina
вальстрона	Valstrona
анива,город	Aniva
альбера-лигуре	Albera_Ligure
атнанг-пуххайм	Attnang-Puchheim
бриалья	Briaglia
алькаудете	Alcaudete
алес	Ales,_Sardinia
вильяконансио	Villaconancio
вервио	Vervio
бузалла	Busalla
боргарелло	Borgarello
валашске-мезиржичи	Valašské_Meziříčí
беневелло	Benevello
бойд	Boyd,_Minnesota
бордон	Bordón
ари	Ari,_Abruzzo
биндура	Bindura
бобровица	Bobrovytsia
вальо-серра	Vaglio_Serra
алькара-ли-фузи	Alcara_li_Fusi
вилланова-маркезана	Villanova_Marchesana
валлизеллен	Wallisellen
берсосилья	Berzosilla
вольфпассинг	Wolfpassing
берривилл,арканзас	Berryville,_Arkansas
бжег	Brzeg
бахман,город	Bahman,_Fars
вольфсбах,австрия	Wolfsbach
альбуньюэлас	Albuñuelas
вецца-д’альба	Vezza_d'Alba
аргайл	Argyle,_Minnesota
асэб	Assab
бусто-гарольфо	Busto_Garolfo
алексеевка,белгородская область	Alexeyevka,_Belgorod_Oblast
вазия	Vasia
акрон,огайо	Akron,_Ohio
бойморто	Boimorto
бад-шёнау	Bad_Schönau
берривилл	Berryville,_Arkansas
али-терме	Alì_Terme
бальдельоу	Baldellou
валеджо	Valeggio,_Lombardy
арвандкенар	Arvandkenar
вилья-дель-росарио,колумбия	Villa_del_Rosario,_Norte_de_Santander
вильямьель-де-толедо	Villamiel_de_Toledo
вилья-дель-рио	Villa_del_Río
вильякаррильо	Villacarrillo
бехамберг	Behamberg
белькастро	Belcastro
аккуафредда	Acquafredda
вуллонгонг	Wollongong
бхимтал	Bhimtal
бранкалеоне	Brancaleone,_Calabria
бела-под-бездезем	Bělá_pod_Bezdězem
брюгге	Bruges
вайц	Weiz
айсанти	Isanti,_Minnesota
вионе	Vione
виллафранка-ин-луниджана	Villafranca_in_Lunigiana
бристоль	Bristol
бад-дойч-альтенбург	Bad_Deutsch-Altenburg
аелли	Aielli
бекли	Beckley,_West_Virginia
алессандрия-дель-карретто	Alessandria_del_Carretto
бурон	Burón
брига-альта	Briga_Alta
винкларн	Winklarn,_Austria
видигульфо	Vidigulfo
валье-дель-салаби	Valle_del_Zalabí
акуто	Acuto
бехшехр	Behshahr
беруин,иллинойс	Berwyn,_Illinois
браунтон,миннесота	Brownton,_Minnesota
виснар	Víznar
вышний волочёк	Vyshny_Volochyok
аренас-дель-рей	Arenas_del_Rey
вулвергемптон	Wolverhampton
бэйпяо	Beipiao
бьянцоне	Bianzone
бербанк,калифорния	Burbank,_California
брисбен	Brisbane
вроцлав	Wrocław
абинск	Abinsk
бостад	Båstad
вентотене	Ventotene
бордигера	Bordighera
айнзидельн	Einsiedeln
ваконе	Vacone
вобарно	Vobarno
баменда	Bamenda
белз	Belz
берчето	Berceto
александрув-куявский	Aleksandrów_Kujawski
бергамаско,италия	Bergamasco,_Piedmont
асутан	Azután
асия,город	Ashiya,_Hyōgo
бенатаэ	Benatae
коммуна вильяррика	Villarrica,_Chile
вильяральто	Villaralto
васильков	Vasylkiv
бомонт	Beaumont,_Texas
баксан	Baksan
бевар	Bewar
ашбах-маркт	Aschbach-Markt
вельс	Wels
барруэло-де-сантульян	Barruelo_de_Santullán
буссолено	Bussoleno
биг-фолс	Big_Falls,_Minnesota
аурано	Aurano
бусто-де-буреба	Busto_de_Bureba
баргарх	Bargarh
анвик	Anvik,_Alaska
виллачидро	Villacidro
андали	Andali
арроне	Arrone
вильявьюдас	Villaviudas
бразилиа	Brasília
бергамаско	Bergamasco,_Piedmont
вилларикка	Villaricca
американ-каньон	American_Canyon,_California
аясе	Ayase,_Kanagawa
блуминг-прери,город	Blooming_Prairie,_Minnesota
амштеттен	Amstetten,_Lower_Austria
абано-терме	Abano_Terme
борго-тичино	Borgo_Ticino
вильяверде-дель-рио	Villaverde_del_Río
бизускьо	Bisuschio
альтавилла-силентина	Altavilla_Silentina
альтлихтенварт	Altlichtenwarth
белчестер	Bellechester,_Minnesota
баффало-лейк,миннесота	Buffalo_Lake,_Minnesota
брок,город	Brok
боруджерд	Borujerd
вимеркате	Vimercate
авейру	Aveiro,_Portugal
артейхо	Arteixo
бальвано	Balvano
барабинск	Barabinsk
бейт-эль	Beit_El
арчинаццо-романо	Arcinazzo_Romano
амстелвен	Amstelveen
владимир,город	Vladimir
алпайн,техас	Alpine,_Texas
байкальск	Baykalsk
бартын	Bartın
анаконда	Anaconda,_Montana
анталаха	Antalaha
алдан,город	Aldan,_Russia
аделаида	Adelaide
бьяндронно	Biandronno
бризи-пойнт,город	Breezy_Point,_Minnesota
альборхе	Alborge
боональ-де-ибор	Bohonal_de_Ibor
боргоманеро	Borgomanero
багли,миннесота	Bagley,_Minnesota
бадринатх	Badrinath
арсикольяр	Arcicóllar
бурханпур	Burhanpur
вентура	Ventura,_California
вильяфранка-де-лос-кабальерос	Villafranca_de_los_Caballeros
аммон,айдахо	Ammon,_Idaho
аллюмьере	Allumiere
вильябаста-де-вальдавия	Villabasta_de_Valdavia
вендроньо	Vendrogno
великие мосты	Velyki_Mosty
босоо	Bozoó
валлесаккарда	Vallesaccarda
балад	Balad,_Iraq
виндхук	Windhoek
айзкраукле	Aizkraukle
альтах	Altach
вилларбойт	Villarboit
витулацио	Vitulazio
бельфорте-дель-кьенти	Belforte_del_Chienti
бастроп,техас	Bastrop,_Texas
анактувук-пасс	Anaktuvuk_Pass,_Alaska
вольта-мантована	Volta_Mantovana
биббона	Bibbona
верхний тагил	Verkhny_Tagil
вильярлуэнго	Villarluengo
баран	Baran,_Rajasthan
быстшица-клодзка	Bystrzyca_Kłodzka
арменто	Armento
бюрг-фёстенхоф	Bürg-Vöstenhof
алькосеро-де-мола	Alcocero_de_Mola
ваган	Vahan,_Armenia
алиха-дель-инфантадо	Alija_del_Infantado
вега-де-эспинареда	Vega_de_Espinareda
брукк-ан-дер-мур	Bruck_an_der_Mur
ваттаро	Vattaro
вентикано	Venticano
вилла-карчина	Villa_Carcina
баццано	Bazzano
бреме	Breme
байро	Bairo
бильдштайн	Bildstein
бака-джат	Baqa-Jatt
бабушкин	Babushkin_(town)
амблер	Ambler,_Alaska
бралло-ди-прегола	Brallo_di_Pregola
алмере	Almere
бузана	Busana
барро,испания	Barro
бюрмос	Bürmoos
бови,миннесота	Bovey,_Minnesota
вирле-пьемонте	Virle_Piemonte
вытегра	Vytegra
бродница	Brodnica
бьяндрате	Biandrate
вакри	Vacri
ангул	Angul
айкурцио	Aicurzio
коммуна версуа	Versoix
виндигштайг	Windigsteig
вильхельмсбург,нижняя австрия	Wilhelmsburg,_Austria
борутта	Borutta
авилес	Avilés
село башка	Baška_(Frýdek-Místek_District)
вигуццоло	Viguzzolo
вейхерово	Wejherowo
бжег-дольны	Brzeg_Dolny
альбано-лациале	Albano_Laziale
бастида-панкарана	Bastida_Pancarana
бене-ларио	Bene_Lario
анива	Aniva
ван-бьюрен	Van_Buren,_Arkansas
бахман	Bahman,_Fars
арадео	Aradeo
ардебиль	Ardabil
валья	Vaglia
ардаггер	Ardagger
абакан	Abakan
антрацит,луганская область	Antratsyt
ватутино	Vatutine
вила-ду-конди	Vila_do_Conde
бенавидес	Benavides,_León
вилла-аньедо	Villa_Agnedo
амбой,миннесота	Amboy,_Minnesota
вердалсёра	Verdalsøra
буонабитаколо	Buonabitacolo
волжск	Volzhsk
асадабад	Asadabad,_Iran
вунсокет,род-айленд	Woonsocket,_Rhode_Island
вильягатон	Villagatón
вулвертон,миннесота	Wolverton,_Minnesota
виллендорф	Willendorf
анан,токусима	Anan,_Tokushima
адулис	Adulis
вёртерберг	Wörterberg
вальдеполо	Valdepolo
вильямурьель-де-серрато	Villamuriel_de_Cerrato
виль	Wil
абаза,город	Abaza_(town)
вега-де-санта-мария	Vega_de_Santa_María
виджаявада	Vijayawada
аннаберг,нижняя австрия	Annaberg,_Lower_Austria
белджойозо	Belgioioso,_Lombardy
бедиас	Bedias,_Texas
алексин	Aleksin
аксум,город	Axum
буссо	Busso
баттамбанг,город	Battambang
виллапьяна	Villapiana
араусо-де-торре	Arauzo_de_Torre
вольтидо	Voltido
вегильяс-де-ла-сьерра	Veguillas_de_la_Sierra
аноя	Anoia,_Calabria
врангель,аляска	Wrangell,_Alaska
вилланова-мондови	Villanova_Mondovì
ариенцо	Arienzo
бейтар-илит	Beitar_Illit
аквинкум	Aquincum
аиса	Aísa
бругг	Brugg
вилламайна	Villamaina
бульдаджи	Boldaji
вираншехир	Viranşehir
асперхофен	Asperhofen
барро	Barro
авильяно умбро	Avigliano_Umbro
блайбург	Bleiburg
волин	Wolin_(town)
амаро	Amaro,_Friuli
бови	Bovey,_Minnesota
арандига	Arándiga
беас-де-сегура	Beas_de_Segura
бова-марина	Bova_Marina
барберино-валь-д’эльса	Barberino_Val_d'Elsa
вильодриго	Villodrigo
бернуй-сапардьель	Bernuy-Zapardiel
вудбери	Woodbury,_Minnesota
барджора	Barjora
блу-эрт,город	Blue_Earth,_Minnesota
аланис	Alanís
бытом-оджаньский	Bytom_Odrzański
виваро-романо	Vivaro_Romano
алдан	Aldan,_Russia
район баррейру	Barreiro_(city)
аркола,италия	Arcola,_Liguria
бароне-канавезе	Barone_Canavese
броньятуро	Brognaturo
вилланова-канавезе	Villanova_Canavese
боруп	Borup,_Minnesota
аскурра	Ascurra
аламида	Alameda,_California
антильон	Antillón
вамберк	Vamberk
бетел-хайтс	Bethel_Heights,_Arkansas
белебей	Belebey
бьяндзе	Bianzè
вольтурара-аппула	Volturara_Appula
барбарано-романо	Barbarano_Romano
вахрушево,город	Vakhrusheve
вальпараисо	Valparaíso
бьюл,миннесота	Buhl,_Minnesota
бьюна-виста	Buena_Vista,_Virginia
бруклин-парк,миннесота	Brooklyn_Park,_Minnesota
баге-мелек	Bagh-e_Malek
бенакасон	Benacazón
балаклава	Balaklava
во	Vò
вильяверде-дель-монте	Villaverde_del_Monte
бадолато	Badolato
вендоне	Vendone
беллфлауэр	Bellflower,_California
алипур	Alipore
альгарробо	Algarrobo,_Magdalena
быхава	Bychawa
аньора	Añora
бытом	Bytom
бассет	Bassett,_Nebraska
амрели	Amreli
виллакьяра	Villachiara
атонуэво	Hatonuevo
валье-дель-ретортильо	Valle_del_Retortillo
альберобелло	Alberobello
батак	Batak,_Bulgaria
батон-руж	Baton_Rouge,_Louisiana
барнсвилл	Barnesville,_Minnesota
вельке-капушаны	Veľké_Kapušany
андрус	Andrews,_Texas
борегард	Beauregard_Parish,_Louisiana
бенд,орегон	Bend,_Oregon
буджерру	Buggerru
битча	Bytča
абусир	Abusir
вильямьель-де-ла-сьерра	Villamiel_de_la_Sierra
брукингз	Brookings,_South_Dakota
бломкест,город	Blomkest,_Minnesota
вышкув	Wyszków
бухарест	Bucharest
алегзандрия,город	Alexandria,_Minnesota
вальдесамарио	Valdesamario
бельцы	Bălți
бузэу	Buzău
ванцоне-кон-сан-карло	Vanzone_con_San_Carlo
брейдентон	Bradenton,_Florida
витория-гастейс	Vitoria-Gasteiz
бастида-де-досси	Bastida_de'_Dossi
априлия	Aprilia,_Lazio
вилла-санто-стефано	Villa_Santo_Stefano
восточная провинция	Eastern_Province,_Sierra_Leone
багаха	Bagaha
бергхайм	Bergheim,_Austria
больцано-вичентино	Bolzano_Vicentino
аньовер-де-тахо	Añover_de_Tajo
вейи	Veii
вьесте	Vieste
агуэро,уэска	Agüero,_Huesca
веццано-лигуре	Vezzano_Ligure
берегово	Berehove
аморий	Amorium
арена	Arena,_Calabria
агуарон	Aguarón
бахрайч	Bahraich
бхадрак	Bhadrak
вильянуэва-дель-кампильо	Villanueva_del_Campillo
валлебона	Vallebona
венёв	Venyov
амадора	Amadora
бандаберг	Bundaberg
вильяр-дель-кобо	Villar_del_Cobo
бассано-дель-граппа	Bassano_del_Grappa
аквавива-делле-фонти	Acquaviva_delle_Fonti
вилла-кортезе	Villa_Cortese
вальфурва	Valfurva
бомонт,техас	Beaumont,_Texas
вайлате	Vailate
агуалва-касен	Agualva-Cacém
буй	Buy,_Kostroma_Oblast
андлерсдорф	Andlersdorf
ари,провинция	Ari,_Abruzzo
аруначала	Arunachala
айодхья	Ayodhya
вигазьо	Vigasio
виллалаго	Villalago
боргетто-лодиджано	Borghetto_Lodigiano
буинск,татарстан	Buinsk,_Republic_of_Tatarstan
бреа-де-арагон	Brea_de_Aragón
брезимо	Bresimo
бомпорто	Bomporto
вильярдомпардо	Villardompardo
аргун,город	Argun,_Chechen_Republic
вильц	Wiltz
адельфия	Adelfia
валеджо-суль-минчо	Valeggio_sul_Mincio
волен,город	Wohlen,_Aargau
барбара	Barbara,_Marche
ветто	Vetto
бургоондо	Burgohondo
андервуд,миннесота	Underwood,_Minnesota
арджелато	Argelato
аннаполис	Annapolis,_Maryland
агадир	Agadir
боргетто-ди-вара	Borghetto_di_Vara
баррали	Barrali
аллен,валле-д’аоста	Allein
витторито	Vittorito
бабимост	Babimost
боронедду	Boroneddu
брешелло	Brescello
бидзароне	Bizzarone
бентивольо	Bentivoglio,_Emilia-Romagna
барселона	Barcelona
баньоли-дель-триньо	Bagnoli_del_Trigno
битти	Bitti
асьют	Asyut
боргофранко-суль-по	Borgofranco_sul_Po
баллабио	Ballabio
вилла-чельера	Villa_Celiera
берта,город	Bertha,_Minnesota
бловице	Blovice
бургдорф	Burgdorf,_Switzerland
валдай	Valday
аркоре	Arcore
венгрув	Węgrów
ахмадабад	Ahmedabad
вигиццоло-д’эсте	Vighizzolo_d'Este
берчвуд-виллидж,миннесота	Birchwood_Village,_Minnesota
вроутек	Vroutek
амброз,северная дакота	Ambrose,_North_Dakota
вильяфранка-дель-бьерсо	Villafranca_del_Bierzo
бедестан	Bidestan
авалон,калифорния	Avalon,_California
адамс	Adams,_Minnesota
волосово	Volosovo
антофагаста	Antofagasta
вау	Wau,_South_Sudan
вильянуэва,гуахира	Villanueva,_La_Guajira
банана	Banana,_Democratic_Republic_of_the_Congo
вальдастико	Valdastico
бьянцано	Bianzano
аракажу	Aracaju
визен,бургенланд	Wiesen,_Austria
ас-невес	As_Neves
вальсинни	Valsinni
вальмала	Valmala,_Italy
акиак	Akiak,_Alaska
авока	Avoca,_Minnesota
анакапри	Anacapri
ворожба,город	Vorozhba
альдеакемада	Aldeaquemada
брембьо	Brembio
арнем	Arnhem
альдеа-эн-кабо	Aldea_en_Cabo
белтрами,город	Beltrami,_Minnesota
агуатон	Aguatón
вустер,массачусетс	Worcester,_Massachusetts
больюльос-де-ла-митасьон	Bollullos_de_la_Mitación
брунталь,чехия	Bruntál
адзумино	Azumino,_Nagano
вигольцоне	Vigolzone
ахтубинск	Akhtubinsk
бардо	Bardo,_Poland
багдад	Baghdad
валь-делла-торре	Val_della_Torre
вайнона	Winona,_Mississippi
безенцоне	Besenzone
атена-лукана	Atena_Lucana
археймар	Árheimar
альби,калабрия	Albi,_Calabria
блу-эрт,миннесота	Blue_Earth,_Minnesota
вилла-санта-лучия-дельи-абруцци	Villa_Santa_Lucia_degli_Abruzzi
бавлы	Bavly
бхопал	Bhopal
бискупец	Biskupiec
ботричелло	Botricello
алапаевск	Alapayevsk
альтенмаркт-ан-дер-тристинг	Altenmarkt_an_der_Triesting
батуми	Batumi
бонвичино	Bonvicino
альвиано	Alviano
вилланова-дель-геббо	Villanova_del_Ghebbo
великий устюг	Veliky_Ustyug
вянта,город	Venta
атланта	Atlanta
вепперсдорф	Weppersdorf
бакус,город	Backus,_Minnesota
буларрос	Bularros
вильярментеро-де-кампос	Villarmentero_de_Campos
валье-де-льерп	Valle_de_Lierp
велилья-де-эбро	Velilla_de_Ebro
бозмен,монтана	Bozeman,_Montana
брекенридж,миннесота	Breckenridge,_Minnesota
барбара,город	Barbara,_Marche
ауаса	Awasa
вильянгомес	Villangómez
вальехера	Vallejera
вальдисотто	Valdisotto
белый	Bely,_Tver_Oblast
агуэро	Agüero,_Huesca
аквавива-пичена	Acquaviva_Picena
беллинцаго-ломбардо	Bellinzago_Lombardo
врбове	Vrbové
баран,город	Baran,_Rajasthan
верхний уфалей	Verkhny_Ufaley
акмяне	Akmenė
варси	Varsi
болехов	Bolekhiv
варзане	Varzaneh
аффольтерн-на-альбисе	Affoltern_am_Albis
алонисос	Alonnisos
авиньон	Avignon
абидос	Abydos,_Egypt
аньян	Anyang
виньегра-де-моранья	Viñegra_de_Moraña
веррес	Verrès
бьюкенен,мичиган	Buchanan,_Michigan
бельвельо	Belveglio
алушта	Alushta
алварейдо,город	Alvarado,_Minnesota
аннаполис,мэриленд	Annapolis,_Maryland
брукс	Brooks,_Minnesota
багли,город	Bagley,_Minnesota
борго-а-моццано	Borgo_a_Mozzano
арчевиа	Arcevia
буттрио	Buttrio
вильяльдемиро	Villaldemiro
ваккариццо-альбанезе	Vaccarizzo_Albanese
антананариву	Antananarivo
аккуаланья	Acqualagna
бенсон,миннесота	Benson,_Minnesota
адо-экити	Ado_Ekiti
башт	Basht
бад-ишль	Bad_Ischl
вилланова-суль-арда	Villanova_sull'Arda
велихово	Wielichowo
амблер,аляска	Ambler,_Alaska
бурджо	Burgio
бессарабка	Basarabeasca
ариэль,город	Ariel_(city)
ашеа	Ascea
абдулино	Abdulino
броссо	Brosso
бальтанас	Baltanás
вильялуэнга-де-ла-вега	Villaluenga_de_la_Vega
больбено	Bolbeno
бой-ривер,город	Boy_River,_Minnesota
биббьена	Bibbiena
вескована	Vescovana
аксум	Axum
аннистон,алабама	Anniston,_Alabama
альбьоло	Albiolo
аннака	Annaka,_Gunma
варизелла	Varisella
барроу-ин-фернесс	Barrow-in-Furness
барнум,миннесота	Barnum,_Minnesota
вальверде-де-бургильос	Valverde_de_Burguillos
вильянуэва-де-теба	Villanueva_de_Teba
баболь	Babol
бесейте	Beceite
берни,тасмания	Burnie,_Tasmania
аникщяй	Anykščiai
бревиг-мишн	Brevig_Mission,_Alaska
балта	Balta,_Ukraine
букоба	Bukoba
бад-фишау-брунн	Bad_Fischau-Brunn
бирюсинск	Biryusinsk
аццано-дечимо	Azzano_Decimo
боско-маренго	Bosco_Marengo
ариелли	Arielli
амфиса	Amfissa
большой камень	Bolshoy_Kamen
броды	Brody
вилкавишкис	Vilkaviškis
вуд-лейк,миннесота	Wood_Lake,_Minnesota
вальхункера	Valjunquera
вильянуэва-де-сан-хуан	Villanueva_de_San_Juan
валкеакоски	Valkeakoski
блинденмаркт	Blindenmarkt
бероун	Beroun
бабаэски	Babaeski
амбувумбе	Ambovombe-Androy
варкаус	Varkaus
болниси	Bolnisi
ваднес-хайтс	Vadnais_Heights,_Minnesota
бойро	Boiro
альберт-ли,миннесота	Albert_Lea,_Minnesota
беллегра	Bellegra
вестоне	Vestone
аладжа-хююк	Alaca_Höyük
альмуньенте	Almuniente
аньоне	Agnone
ауровиль	Auroville
аннандейл	Annandale,_Minnesota
альбиано	Albiano
вальдепьелаго	Valdepiélago
андижан	Andijan
альбиньязего	Albignasego
альтавилла-вичентина	Altavilla_Vicentina
барранкилья	Barranquilla
вальденбург	Waldenburg,_Switzerland
альфедена	Alfedena
бренес	Brenes
бехар	Bahar,_Iran
белчестер,город	Bellechester,_Minnesota
бальдиссеро-торинезе	Baldissero_Torinese
бок	Bock,_Minnesota
бониту	Bonito,_Mato_Grosso_do_Sul
бельведере-ланге	Belvedere_Langhe
високе-мито	Vysoké_Mýto
анцола-д’оссола	Anzola_d'Ossola
вилькия	Vilkija
бадулла	Badulla
апетлон	Apetlon
бейра,мозамбик	Beira,_Mozambique
бохня	Bochnia
бяла-подляска	Biała_Podlaska
барано-д’искья	Barano_d'Ischia
апсала	Upsala,_Minnesota
алаканук	Alakanuk,_Alaska
беналла	Benalla
аполлония иллирийская	Apollonia_(Illyria)
амбато	Ambato,_Ecuador
арвад	Arwad
вольтаго-агордино	Voltago_Agordino
вайсензе,австрия	Weissensee,_Austria
асков,миннесота	Askov,_Minnesota
вальо-базиликата	Vaglio_Basilicata
ваццано	Vazzano
брукингз,дакота	Brookings,_South_Dakota
вельки-шенов	Velký_Šenov
альдейре	Aldeire
альма	Alma,_Arkansas
аркос-де-лас-салинас	Arcos_de_las_Salinas
аматриче	Amatrice
борзя	Borzya
барнсвилл,миннесота	Barnesville,_Minnesota
антиок,калифорния	Antioch,_California
аркология	Arcology
берд-айленд,город	Bird_Island,_Minnesota
винтерсвейк	Winterswijk
булл-шолс,арканзас	Bull_Shoals,_Arkansas
абетоне	Abetone
багратионовск	Bagrationovsk
авдеевка	Avdiivka
бандера,техас	Bandera,_Texas
вальверде-дель-фресно	Valverde_del_Fresno
бордано	Bordano
висфлек	Wiesfleck
бордальба	Bordalba
бляховня	Blachownia
вальджойе	Valgioie
биббьяно	Bibbiano
буджано	Buggiano
баскуньяна	Bascuñana
вельки-медер	Veľký_Meder
аира	Aira,_Kagoshima_(Aira)
беллуно	Belluno
валь-де-сан-мартин	Val_de_San_Martín
бад-фигаун	Bad_Vigaun
барранкас,гуахира	Barrancas,_La_Guajira
вировитица	Virovitica
барвенково	Barvinkove
брузненго	Brusnengo
виетри-суль-маре	Vietri_sul_Mare
альба	Alba,_Piedmont
адыгейск	Adygeysk
буэу	Bueu
амман	Amman
анькан	Ankang
богучар	Boguchar
альфахарин	Alfajarín
валки,город	Valky
брандис-над-лабем-стара-болеслав	Brandýs_nad_Labem-Stará_Boleslav
авиано	Aviano
березань,город	Berezan
айас	Ayas,_Adana
аньяделло	Agnadello
виньола-фалезина	Vignola-Falesina
виллафаллетто	Villafalletto
биласпур,город	Bilaspur,_Chhattisgarh
белиз	Belize_City
богданович,город	Bogdanovich_(town)
альбарето	Albareto
барлинг,арканзас	Barling,_Arkansas
баодин	Baoding
барреа	Barrea
баликпапан	Balikpapan
бортигали	Bortigali
ветцикон	Wetzikon
анян	Anyang,_Gyeonggi
баабон-де-эсгева	Bahabón_de_Esgueva
вимодроне	Vimodrone
алькала-ла-реаль	Alcalá_la_Real
вальярта-де-буреба	Vallarta_de_Bureba
алмада	Almada
вознесенск	Voznesensk
бильче-золотое	Bilche_Zolote
бонн	Bonn
ардаль	Ardal
айронтон,город	Ironton,_Minnesota
валло-ди-нера	Vallo_di_Nera
болоньяно	Bolognano
ахалкалаки	Akhalkalaki
бинасед	Binaced
вальдина	Valdina
аджмер	Ajmer
вильяманин	Villamanín
агуаскальентес,город	Aguascalientes,_Aguascalientes
аккуаканина	Acquacanina
арвада	Arvada,_Colorado
альфамен	Alfamén
айяс	Ayas,_Aosta_Valley
виллага	Villaga
вильяэспаса	Villaespasa
андало-валтеллино	Andalo_Valtellino
боргаро-торинезе	Borgaro_Torinese
адак	Adak,_Alaska
ансфельден	Ansfelden
вестервик	Västervik
боргоне-суза	Borgone_Susa
берг-им-драуталь	Berg_im_Drautal
бишофсхофен	Bischofshofen
аренильяс-де-риописуэрга	Arenillas_de_Riopisuerga
аррах,индия	Arrah
валье-де-серрато	Valle_de_Cerrato
ананд	Anand,_Gujarat
алжир	Algiers
брэдли	Bradley,_Arkansas
бхаратпур	Bharatpur,_Rajasthan
ветралла	Vetralla
анини	Anini
виньоло	Vignolo
вёргль	Wörgl
блессаньо	Blessagno
вилла-сантина	Villa_Santina
бялогард	Białogard
брекстад	Brekstad
алибаг	Alibag
бромберг,австрия	Bromberg,_Lower_Austria
армунджа	Armungia
буональберго	Buonalbergo
вильяфранка-дель-кампо	Villafranca_del_Campo
атри	Atri,_Abruzzo
богородицк	Bogoroditsk
америка-ii	América_II,_Tamaulipas
амлах	Amlach
ауронцо-ди-кадоре	Auronzo_di_Cadore
вайтен	Weiten
альбезе-кон-кассано	Albese_con_Cassano
вик-ауф-фёр	Wyk_auf_Föhr
блажова	Błażowa
баньоли-ирпино	Bagnoli_Irpino
брейнерд	Brainerd,_Minnesota
беттола	Bettola
асан,город	Asan
бейт-ханун	Beit_Hanoun
валч	Wałcz
альтенбург,нижняя австрия	Altenburg,_Lower_Austria
бхиванди	Bhiwandi
вильяверде-мохина	Villaverde-Mogina
буронцо	Buronzo
брукнойдорф	Bruckneudorf
барчис	Barcis
аугуста,сицилия	Augusta,_Sicily
айнсон	Ainzón
артонье	Artogne
аццано-мелла	Azzano_Mella
буддузо	Buddusò
альбанчес-де-убеда	Albanchez_de_Mágina
арау	Aarau
аррах	Arrah
апатиты	Apatity
варнсдорф	Varnsdorf
бхубанешвар	Bhubaneswar
бяла,польша	Biała_Prudnicka
аннаба	Annaba
антрацит	Antratsyt
выжиск	Wyrzysk
валлелонга	Vallelonga
ватикан	Vatican_City
валье-де-эчо	Valle_de_Hecho
баттамбанг	Battambang
арклоу	Arklow
ахтырка	Okhtyrka
володарск	Volodarsk,_Russia
вимперк	Vimperk
вальверде-де-ла-вирхен	Valverde_de_la_Virgen
бейпорт,город	Bayport,_Minnesota
бельфьоре	Belfiore
авка	Awka
атуотер,миннесота	Atwater,_Minnesota
бафт	Baft
валь-реццо	Val_Rezzo
анте-сент-андре	Antey-Saint-André
беллария-иджеа-марина	Bellaria_–_Igea_Marina
бардхаман	Bardhaman
богданци	Bogdanci
вайрано-патенора	Vairano_Patenora
аджуд	Adjud
валпово	Valpovo
видиша	Vidisha
виллизау	Willisau
брея,италия	Breia
вильянуэва-де-лас-мансанас	Villanueva_de_las_Manzanas
авейль	Aweil,_South_Sudan
вилласимиус	Villasimius
арнавуткёй	Arnavutköy_(district)
больяско	Bogliasco
басконес-де-охеда	Báscones_de_Ojeda
беромюнстер	Beromünster
бохов	Bochov
белополье	Bilopillia
вальдеморалес	Valdemorales
абанто	Abanto
броквилл,онтарио	Brockville
боргетто-д’арроша	Borghetto_d'Arroscia
басти,уттар-прадеш	Basti,_Uttar_Pradesh
ботоу	Botou
бентонвилл	Bentonville,_Arkansas
буэна-парк	Buena_Park,_California
американ-форк	American_Fork,_Utah
берестечко	Berestechko
браунсдейл	Brownsdale,_Minnesota
вильялькон	Villalcón
бьенно	Bienno
артик	Artik
блекуа-и-торрес	Blecua_y_Torres
алиабад	Aliabad-e_Katul
бук,познанский повят	Buk
беррокалехо	Berrocalejo
аргос	Argos
васко-да-гама	Vasco_da_Gama,_Goa
бюль,фрибур	Bulle
ангри	Angri
ай-ханум	Ai-Khanoum
верт	Weert
астен,австрия	Asten,_Austria
бейт-джала	Beit_Jala
брацигово	Bratsigovo
барди,город	Bardi,_Emilia-Romagna
аматус	Amathus
вильяорнате-и-кастро	Villaornate_y_Castro
авеньо	Avegno,_Liguria
валдиз,аляска	Valdez,_Alaska
амбикапур	Ambikapur,_India
ариньо	Ariño
виковаро	Vicovaro
беседильяс	Becedillas
аветрана	Avetrana
вальфаббрика	Valfabbrica
баколод	Bacolod
белвидир	Belvidere,_Illinois
ван-бьюрен,арканзас	Van_Buren,_Arkansas
аргос,город	Argos
бекер,город	Becker,_Minnesota
бангалор	Bangalore
верджиния,миннесота	Virginia,_Minnesota
арре	Arre,_Veneto
вальс-зиценхайм	Wals-Siezenheim
али,сицилия	Alì
борисоглебск	Borisoglebsk
борка-ди-кадоре	Borca_di_Cadore
остров астипалея	Astypalaia
бургос,сардиния	Burgos,_Sardinia
вальдекаса	Valdecasa
брест	Brest,_France
акри,город	Acri
венетико	Venetico
вальдемора	Valdemora
визеу	Viseu
акаа	Akaa
верт,нидерланды	Weert
вельо	Veglio
барбареско,город	Barbaresco,_Piedmont
бьентина	Bientina
андедзено	Andezeno
вискаинос	Vizcaínos
белл,калифорния	Bell,_California
вилла-пома	Villa_Poma
айл,город	Isle,_Minnesota
виторкьяно	Vitorchiano
водзислав-слёнски	Wodzisław_Śląski
вас,город	Vas,_Veneto
балангир	Balangir
бхатпара	Bhatpara
арден-хилс,миннесота	Arden_Hills,_Minnesota
болдуин-парк	Baldwin_Park,_California
билокси	Biloxi,_Mississippi
аджерола	Agerola
вердерио-инфериоре	Verderio_Inferiore
борсиппа	Borsippa
борбона	Borbona
баранув-сандомерский	Baranów_Sandomierski
винчи	Vinci,_Tuscany
баньоли-ди-сопра	Bagnoli_di_Sopra
альтмюнстер	Altmünster
айона	Iona,_Minnesota
бови,город	Bovey,_Minnesota
альтопашо	Altopascio
альтино	Altino,_Abruzzo
высоковск	Vysokovsk
вилла-латина	Villa_Latina
алькарасехос	Alcaracejos
вильяльба-де-гуардо	Villalba_de_Guardo
барри,миннесота	Barry,_Minnesota
бехар,хамадан	Bahar,_Iran
апасео-эль-альто	Apaseo_el_Alto
бриттоли	Brittoli
брендзоне	Brenzone
виллаваллелонга	Villavallelonga
баджер,миннесота	Badger,_Minnesota
бемпур	Bampur
буккьянико	Bucchianico
бельмонте-де-сан-хосе	Belmonte_de_San_José
бекер,миннесота	Becker,_Minnesota
вагна	Wagna
вельск	Velsk
бруньято	Brugnato
альтхайм	Altheim,_Austria
андрано	Andrano
волос,город	Volos
акаба	Aqaba
блайт	Blythe,_California
бидерманнсдорф	Biedermannsdorf
борегард,приход луизиана	Beauregard_Parish,_Louisiana
агилар-де-буреба	Aguilar_de_Bureba
бранд-лабен	Brand-Laaben
баттипалья	Battipaglia
бийск	Biysk
муниципалитет бучине	Bucine
бренна	Brenna,_Lombardy
виллаперуччо	Villaperuccio
венцоне	Venzone
вишнупур	Bishnupur,_Bankura
вабальнинкас	Vabalninkas
верндейл,город	Verndale,_Minnesota
ансо	Ansó
баэльс	Baélls
баскапе	Bascapè
аммон	Ammon,_Idaho
воткинск	Votkinsk
бризигелла	Brisighella
альмерия	Almería
бадези	Badesi
бирштонас	Birštonas
вайсенбах-ан-дер-тристинг	Weissenbach_an_der_Triesting
вазанелло	Vasanello
вильянуэва-де-гумьель	Villanueva_de_Gumiel
венглинец	Węgliniec
блевио	Blevio
айл,миннесота	Isle,_Minnesota
валенсия-дель-вентосо	Valencia_del_Ventoso
брук-парк	Brook_Park,_Minnesota
баденас	Bádenas
бошруйе	Boshruyeh
бади-баситт	Bady_Bassitt
бриссаго-вальтравалья	Brissago-Valtravaglia
блуминг-прери,миннесота	Blooming_Prairie,_Minnesota
артштеттен-пёбринг	Artstetten-Pöbring
вернате	Vernate,_Lombardy
бельбимбре	Belbimbre
бртнице	Brtnice
бухбах,австрия	Buchbach,_Austria
аччельо	Acceglio
берчвуд-виллидж,город	Birchwood_Village,_Minnesota
бейпорт	Bayport,_Minnesota
альберта	Alberta,_Minnesota
висьедо	Visiedo
буньяра	Bugnara
виллафранка-падована	Villafranca_Padovana
ардешен	Ardeşen
биатрис	Beatrice,_Nebraska
вулф-лейк,миннесота	Wolf_Lake,_Minnesota
бускате	Buscate
вайшали	Vaishali_(ancient_city)
бриньяно-фраската	Brignano-Frascata
вэйнань	Weinan
альбуньян	Albuñán
боойо	Bohoyo
битлис	Bitlis
веццано	Vezzano,_Trentino
бозаро	Bosaro
барбадильо-дель-пес	Barbadillo_del_Pez
бальдиссеро-д’альба	Baldissero_d'Alba
берцано-ди-сан-пьетро	Berzano_di_San_Pietro
бергхайм,флахгау	Bergheim,_Austria
байбурт	Bayburt
баджер,город	Badger,_Minnesota
бернате-тичино	Bernate_Ticino
бегусарай	Begusarai
аннандейл,миннесота	Annandale,_Minnesota
бледжо-суперьоре	Bleggio_Superiore
бардинето	Bardineto
виано	Viano
вилланова-трускеду	Villanova_Truschedu
агон,сарагоса	Agón
барделло	Bardello
виццола-тичино	Vizzola_Ticino
бигелоу,миннесота	Bigelow,_Minnesota
берегуардо	Bereguardo
анактувук-пасс,аляска	Anaktuvuk_Pass,_Alaska
боттино,северная дакота	Bottineau,_North_Dakota
висмар	Wismar
берджеджи	Bergeggi
вильяморонта	Villamoronta
барроу,аляска	Barrow,_Alaska
алланд	Alland
бобрка	Bibrka
алор-сетар	Alor_Setar
вайнграбен	Weingraben
бакнер	Buckner,_Arkansas
бен	Ben,_Iran
брегано	Bregano
берсьянос-дель-реаль-камино	Bercianos_del_Real_Camino
вильяарта	Villaharta
батман,город	Batman,_Turkey
вильянуэва-дель-арискаль	Villanueva_del_Ariscal
бонемерсе	Bonemerse
боффалора-сопра-тичино	Boffalora_sopra_Ticino
бхудж	Bhuj
аморози	Amorosi
бонилья-де-ла-сьерра	Bonilla_de_la_Sierra
ахар	Ahar
альверня	Alwernia
аллаи	Allai,_Sardinia
вирбалис	Virbalis
арагацотн	Aragatsotn_(village)
восход,московская область	Voskhod,_Moscow_Oblast
баски	Baschi
виллар-сан-костанцо	Villar_San_Costanzo
балхаш,город	Balkhash_(city)
белая калитва	Belaya_Kalitva
аустис	Austis
айроле	Airole
бизамберг	Bisamberg
акиак,аляска	Akiak,_Alaska
виксберг,миссисипи	Vicksburg,_Mississippi
вордингборг	Vordingborg
боттино,дакота	Bottineau,_North_Dakota
вигоново	Vigonovo
верджемоли	Vergemoli
аламедилья	Alamedilla
барра-велья	Barra_Velha
алма-ата	Almaty
бодх-гая	Bodh_Gaya
вила-нова-ди-гая	Vila_Nova_de_Gaia
бардаскан	Bardaskan
аурангабад	Aurangabad,_Maharashtra
всеволожск	Vsevolozhsk
антсла	Antsla
вальдеканьяс-де-тахо	Valdecañas_de_Tajo
беура-кардецца	Beura-Cardezza
бугуруслан	Buguruslan
актобе	Aktobe
вернанте	Vernante
богушув-горце	Boguszów-Gorce
валлекорса	Vallecorsa
бульгарограссо	Bulgarograsso
асналькасар	Aznalcázar
бьюна-виста,виргиния	Buena_Vista,_Virginia
бехихар	Begíjar
бекли,виргиния	Beckley,_West_Virginia
велье,италия	Veglie
боулдер	Boulder,_Colorado
барлетта	Barletta
беруин	Berwyn,_Illinois
вонхоцк	Wąchock
алмело	Almelo
альтленгбах	Altlengbach
бока	Boca,_Novara
амерсфорт	Amersfoort
андрия	Andria
брукстон,миннесота	Brookston,_Minnesota
бекли,западная виргиния	Beckley,_West_Virginia
баньоло-кремаско	Bagnolo_Cremasco
версуа	Versoix
борисполь	Boryspil
бозентино	Bosentino
альмоарин	Almoharín
альбуццано	Albuzzano
веркана	Vercana
балад,ирак	Balad,_Iraq
бехине	Bechyně
амритсар	Amritsar
беканкур	Bécancour,_Quebec
антиб	Antibes
адамов	Adamov_(Blansko_District)
арцакена	Arzachena
бешикдюзю	Beşikdüzü
вико-нель-лацио	Vico_nel_Lazio
айяс,италия	Ayas,_Aosta_Valley
блитар	Blitar
анверса-дельи-абруцци	Anversa_degli_Abruzzi
бордолано	Bordolano
боргорозе	Borgorose
варамин	Varamin
барретт,город	Barrett,_Minnesota
алькабон	Alcabón
альбаретто-делла-торре	Albaretto_della_Torre
валаклоче	Valacloche
велиж	Velizh
асколи-сатриано	Ascoli_Satriano
вальдерас	Valderas
апрелевка	Aprelevka
вибо-валентия	Vibo_Valentia
браччано	Bracciano
араусо-де-сальсе	Arauzo_de_Salce
вараби	Warabi,_Saitama
валле-салимбене	Valle_Salimbene
вильяррабе	Villarrabé
альбано-верчеллезе	Albano_Vercellese
боссоласко	Bossolasco
вьяле	Viale
алба-юлия	Alba_Iulia
бальса-де-вес	Balsa_de_Ves
бреда	Breda
варка	Warka
вилласор	Villasor
алжир,город	Algiers
вильянуэва-де-кордова	Villanueva_de_Córdoba
вальда	Valda
аквапенденте	Acquapendente
антрацит,область	Antratsyt
аламида,калифорния	Alameda,_California
айова-сити	Iowa_City,_Iowa
бишо,город	Bhisho
вуллерсдорф	Wullersdorf
аки	Aki,_Kōchi
верретто	Verretto
виджано	Viggiano
айгуамурсия	Aiguamúrcia
ау-ам-лайтаберге	Au_am_Leithaberge
выру	Võru
вестинье	Vestignè
боббио	Bobbio
винасейте	Vinaceite
брайтенау,австрия	Breitenau,_Lower_Austria
альтидона	Altidona
берд-айленд	Bird_Island,_Minnesota
вимпассинг-им-шварцатале	Wimpassing_im_Schwarzatale
алькала-де-монкайо	Alcalá_de_Moncayo
вальде-усьеса	Valde-Ucieza
багдати	Baghdati
биробиджан	Birobidzhan
аньцин	Anqing
арнаско	Arnasco
вильямайор-де-лос-монтес	Villamayor_de_los_Montes
вильяэскуса-де-роа	Villaescusa_de_Roa
ватра	Vatra,_Moldova
бхаванипатна	Bhawanipatna
бодзентын	Bodzentyn
буттапьетра	Buttapietra
бановичи,город	Banovići
варенна	Varenna
алештар	Aleshtar
волен	Wohlen,_Aargau
альяна	Agliana
артём,город	Artyom,_Russia
берегаццо-кон-фильяро	Beregazzo_con_Figliaro
высоке-мазовецке	Wysokie_Mazowieckie
вальверде-де-мерида	Valverde_de_Mérida
вернон-сентер,город	Vernon_Center,_Minnesota
веролавеккья	Verolavecchia
артур,айова	Arthur,_Iowa
букиттинги	Bukittinggi
бонаб	Bonab
адма	Admah
виццоло-предабисси	Vizzolo_Predabissi
аиои	Aioi,_Hyōgo
бонорва	Bonorva
векшняй	Viekšniai
баратили-сан-пьетро	Baratili_San_Pietro
боннерс-ферри	Bonners_Ferry,_Idaho
вятские поляны	Vyatskiye_Polyany
броккостелла	Broccostella
вильяльба-де-дуэро	Villalba_de_Duero
бисби	Bisbee,_Arizona
верхняя тура	Verkhnyaya_Tura
байвабик,город	Biwabik,_Minnesota
алендин	Alhendín
брольяно	Brogliano
валка	Valka
восточная провинция,сьерра-леоне	Eastern_Province,_Sierra_Leone
блэкдак,миннесота	Blackduck,_Minnesota
брион,испания	Brión
бьюл	Buhl,_Minnesota
вильяселан	Villaselán
беттлс	Bettles,_Alaska
община бюрен	Buren
асаго	Asago,_Hyōgo
бошань	Boshan_District
веролануова	Verolanuova
абисанда	Abizanda
братислава	Bratislava
брандон,город	Brandon,_Minnesota
белёв	Belyov
амами,город	Amami,_Kagoshima
амакуса	Amakusa,_Kumamoto
бельск-подляски	Bielsk_Podlaski
браунс-валли	Browns_Valley,_Minnesota
браунтон,город	Brownton,_Minnesota
вольногорск	Vilnohirsk
бастия-мондови	Bastia_Mondovì
байвабик,миннесота	Biwabik,_Minnesota
анадырь	Anadyr_(town)
аванш	Avenches
вайсвассер,верхняя лужица	Weißwasser
биллингс	Billings,_Montana
буинск	Buinsk,_Republic_of_Tatarstan
альфос-де-брисия	Alfoz_de_Bricia
аланно	Alanno
богор	Bogor
вирудунагар	Virudhunagar
выкса	Vyksa
бжеще	Brzeszcze
бистрица,румыния	Bistrița
блумфонтейн	Bloemfontein
вильялуэнга-де-ла-сагра	Villaluenga_de_la_Sagra
бозия	Bosia,_Piedmont
боньянко	Bognanco
боубеллс,северная дакота	Bowbells,_North_Dakota
вадсё	Vadsø
бойнице	Bojnice
бин-касим	Bin_Qasim_Town
аренс-де-льедо	Arens_de_Lledó
альмединилья	Almedinilla
андау	Andau
бокфлис	Bockfließ
вильольдо	Villoldo
аузония	Ausonia,_Lazio
акрон	Akron,_Ohio
банияс,израиль	Banias
бормида	Bormida,_Liguria
аркуата-дель-тронто	Arquata_del_Tronto
брайтенштайн,австрия	Breitenstein,_Lower_Austria
боторрита	Botorrita
амуско	Amusco
алиано	Aliano
витербо	Viterbo
витикузо	Viticuso
варкала	Varkala
ангуилара-венета	Anguillara_Veneta
альболоте	Albolote
бедолло	Bedollo
винцальо	Vinzaglio
брузимпьяно	Brusimpiano
бжесць-куявский	Brześć_Kujawski
баббитт	Babbitt,_Minnesota
башка	Baška_(Frýdek-Místek_District)
амбой,город	Amboy,_Minnesota
верховцево	Verkhivtseve
варано-борги	Varano_Borghi
азуса	Azusa,_California
банана,демократическая республика конго	Banana,_Democratic_Republic_of_the_Congo
богуслав	Bohuslav
аллерона	Allerona
аквилея	Aquileia
барыш,город	Barysh
бреганце	Breganze
бонавиго	Bonavigo
бульбуэнте	Bulbuente
ананьи	Anagni
брум	Broome,_Western_Australia
виола,город	Viola,_Piedmont
акри	Acri
бари-сардо	Bari_Sardo
аллувьони-камбио	Alluvioni_Cambiò
верхняя пышма	Verkhnyaya_Pyshma
вилла-эстенсе	Villa_Estense
борго-паче	Borgo_Pace
аркола	Arcola,_Liguria
александрув-лодзинский	Aleksandrów_Łódzki
бербанк	Burbank,_California
буксар	Buxar
бергиш-гладбах	Bergisch_Gladbach
вилла-рендена	Villa_Rendena
абехуэла	Abejuela
базарган	Bazargan,_Iran
аньцю	Anqiu
бриндизи	Brindisi
бедиццоле	Bedizzole
виллаверла	Villaverla
бокситогорск	Boksitogorsk
вьяра	Vyara
акворт	Acworth,_Georgia
вильяэскуса-ла-сомбрия	Villaescusa_la_Sombría
вокка	Vocca
барбареско	Barbaresco,_Piedmont
бионе	Bione
вале,грузия	Vale,_Georgia
бибербах,австрия	Biberbach,_Austria
беппу	Beppu,_Ōita
власеница	Vlasenica
аелло-дель-фриули	Aiello_del_Friuli
алварейдо,миннесота	Alvarado,_Minnesota
бормио	Bormio
вильянуэва-де-богас	Villanueva_de_Bogas
бремгартен	Bremgarten,_Aargau
виго-рендена	Vigo_Rendena
барнсвилл,город	Barnesville,_Minnesota
баньоло-пьемонте	Bagnolo_Piemonte
аркашон	Arcachon
боджнурд	Bojnord
бомба,абруццо	Bomba,_Abruzzo
валашске-клобоуки	Valašské_Klobouky
аксарай	Aksaray
браке,везер	Brake,_Lower_Saxony
аббадия-сан-сальваторе	Abbadia_San_Salvatore
айруно	Airuno
вальпеллин	Valpelline,_Aosta_Valley
вильямонтан-де-ла-вальдуэрна	Villamontán_de_la_Valduerna
барсена-де-кампос	Bárcena_de_Campos
аквавива-д’изерния	Acquaviva_d'Isernia
антверпен	Antwerp
вурден	Woerden
вилламассарджа	Villamassargia
браунау-ам-инн	Braunau_am_Inn
аббатеджо	Abbateggio
вайсвассер	Weißwasser
бадия-полезине	Badia_Polesine
велье	Veglie
аверара	Averara
арозио	Arosio
бэнбу	Bengbu
агрономика	Agronômica,_Santa_Catarina
вецци-портио	Vezzi_Portio
агсбах	Aggsbach
выборг	Vyborg
вальдесате	Valdezate
барроман	Barromán
альбисола-супериоре	Albisola_Superiore
бельджирате	Belgirate
вильянуэва-дель-рио-и-минас	Villanueva_del_Río_y_Minas
виллард	Villard,_Minnesota
бакнер,арканзас	Buckner,_Arkansas
бивер-крик	Beaver_Creek,_Minnesota
бад-радкерсбург	Bad_Radkersburg
бытув	Bytów
аскреа	Ascrea
витница	Witnica
бова	Bova,_Calabria
альтабле	Altable
бейнетте	Beinette
альметьевск	Almetyevsk
бербера	Berbera
вильяррубия-де-сантьяго	Villarrubia_de_Santiago
варна	Varna
вьерлас	Vierlas
бережаны	Berezhany
вавр,бельгия	Wavre
вильямесиас	Villamesías
вайсензе	Weissensee,_Austria
веста,миннесота	Vesta,_Minnesota
вильягалихо	Villagalijo
боббио,италия	Bobbio
бульо-ин-монте	Buglio_in_Monte
багуэс	Bagüés
буриаско	Buriasco
ваттенс	Wattens
аркваз	Arakvaz
арида	Arida,_Wakayama
вильямоль	Villamol
апсала,город	Upsala,_Minnesota
акуара	Aquara
буччано	Bucciano
айзенкаппель-феллах	Eisenkappel-Vellach
бхандара	Bhandara
бланкас	Blancas
бильче-золотое,район	Bilche_Zolote
белая церковь	Bila_Tserkva
вистабелья-де-уэрва	Vistabella_de_Huerva
бороре	Borore
алагир	Alagir
бобова,город	Bobowa
витулано	Vitulano
альдеануэва-де-барбарроя	Aldeanueva_de_Barbarroya
вильяэлес-де-вальдавия	Villaeles_de_Valdavia
ахен	Aachen
аспарн-ан-дер-цайя	Asparn_an_der_Zaya
вайдор	Vidor,_Texas
вукосавле	Vukosavlje
барсьенсе	Barcience
алес,италия	Ales,_Sardinia
буттильера-д’асти	Buttigliera_d'Asti
альмодовар-дель-пинар	Almodóvar_del_Pinar
валь-мазино	Val_Masino
вильяр-де-лос-наваррос	Villar_de_los_Navarros
вайден-ан-дер-марх	Weiden_an_der_March
валлемайо	Vallemaio
ачинск	Achinsk
ванимо	Vanimo
вальтопина	Valtopina
америка-ii,тамаулипас	América_II,_Tamaulipas
блайтвилл	Blytheville,_Arkansas
амравати	Amravati
вейс	Veys
вико-дель-гаргано	Vico_del_Gargano
альморокс	Almorox
висла,город	Wisła
бахарампур	Baharampur
вильфранш-сюр-мер	Villefranche-sur-Mer
броктон,массачусетс	Brockton,_Massachusetts
алтеймер	Altheimer,_Arkansas
амелья	Ameglia
бустильо-де-ла-вега	Bustillo_de_la_Vega
березовка,одесская область	Berezivka
вяземский	Vyazemsky,_Khabarovsk_Krai
вивероне	Viverone
антиохия	Antioch
борго-сан-сиро	Borgo_San_Siro
аллеппи	Alappuzha
вернал	Vernal,_Utah
альто	Alto,_Piedmont
бромберг,нижняя австрия	Bromberg,_Lower_Austria
борджо-верецци	Borgio_Verezzi
аргун	Argun,_Chechen_Republic
верруа-по	Verrua_Po
андапа	Andapa
арчидоссо	Arcidosso
амбалавао	Ambalavao
беллано	Bellano
бекингем,техас	Buckingham,_Richardson,_Texas
альбореа	Alborea
вакаяма	Wakayama,_Wakayama
винервальд	Wienerwald,_Austria
альта-виста,оттава	Alta_Vista,_Ottawa
вестенанова	Vestenanova
багхпат	Baghpat
бату,город	Batu_(city)
волчин	Wołczyn
бассано-брешано	Bassano_Bresciano
ворб	Worb
община венло	Venlo
вернон-сентер,миннесота	Vernon_Center,_Minnesota
вальдуджа	Valduggia
бремертон	Bremerton,_Washington
берат	Berat
вихоревка	Vikhorevka
берта	Bertha,_Minnesota
аттапы,город	Attapeu
бардзано	Barzanò
валли-дель-пазубио	Valli_del_Pasubio
вальмоццола	Valmozzola
барретт	Barrett,_Minnesota
вилла-бискосси	Villa_Biscossi
бейра	Beira,_Mozambique
вайлдвуд	Wildwood,_New_Jersey
арна,валле-д’аоста	Arnad
амато	Amato
аксамс	Axams
варци	Varzi
альба-адриатика	Alba_Adriatica
виссо	Visso
влодава	Włodawa
бежунь	Bieżuń
байло	Bailo,_Spain
бониту,мату-гросу-ду-сул	Bonito,_Mato_Grosso_do_Sul
алькофен	Alkoven
село ваган	Vahan,_Armenia
биоград-на-мору	Biograd_na_Moru
астен	Asten,_Austria
брионе,провинция тренто	Brione,_Trentino
агридженто	Agrigento
бремен	Bremen
арозио,италия	Arosio
алчевск	Alchevsk
бертрум	Burtrum,_Minnesota
бартошице	Bartoszyce
арта,греция	Arta,_Greece
арлена-ди-кастро	Arlena_di_Castro
айванхо,миннесота	Ivanhoe,_Minnesota
аббиатеграссо	Abbiategrasso
вальгрегентино	Valgreghentino
баттуда	Battuda
берта,миннесота	Bertha,_Minnesota
аелло-калабро	Aiello_Calabro
варберг	Varberg
вудбери,миннесота	Woodbury,_Minnesota
вантаа	Vantaa
врбовец	Vrbovec
бадулес	Badules
агура-хиллз	Agoura_Hills,_California
брендола	Brendola
амрисвиль	Amriswil
бессуде	Bessude
андрус,техас	Andrews,_Texas
варшава	Warsaw
вильядос	Villadoz
бертуа	Bertoua
бриенно	Brienno
анцио	Anzio
вайле	Vejle
бендер-хомейни	Bandar-e_Emam_Khomeyni
аудиторе	Auditore
анока	Anoka,_Minnesota
вальграна	Valgrana
анапа	Anapa
блэкдак,город	Blackduck,_Minnesota
алеппо	Aleppo
ведано-олона	Vedano_Olona
абдон-батиста	Abdon_Batista
вербания	Verbania
абья-палуоя	Abja-Paluoja
аллакакет,аляска	Allakaket,_Alaska
альбертвилл,миннесота	Albertville,_Minnesota
барриос-де-колина	Barrios_de_Colina
биски,миннесота	Biscay,_Minnesota
вашим	Washim
аркозанти	Arcosanti
алонте	Alonte
африко	Africo
верроне	Verrone
алькофен,верхняя австрия	Alkoven
бакман,миннесота	Buckman,_Minnesota
белокуриха	Belokurikha
бановичи	Banovići
анока,миннесота	Anoka,_Minnesota
боровани	Borovany_(České_Budějovice_District)
агаццано	Agazzano
велезо	Veleso
виноградов,город	Vynohradiv
бальме	Balme
виллаурбана	Villaurbana
аккуаппеза	Acquappesa
брегенц	Bregenz
андон	Andong
вилаплана	Vilaplana
бансвара	Banswara
вильяно-бьеллезе	Vigliano_Biellese
болоньола	Bolognola
болленго	Bollengo
альберуэла-де-тубо	Alberuela_de_Tubo
бехис	Bejís
ананд,город	Anand,_Gujarat
браунс-валли,город	Browns_Valley,_Minnesota
альбертвилл	Albertville,_Minnesota
винер-нойштадт	Wiener_Neustadt
баньоло-ин-пьяно	Bagnolo_in_Piano
атлантик-сити	Atlantic_City,_New_Jersey
белу-вали	Belo_Vale
вильянуэва-де-алькардете	Villanueva_de_Alcardete
анандпур сахиб	Anandpur_Sahib
альдеануэва-де-ла-вера	Aldeanueva_de_la_Vera
бассано-ин-теверина	Bassano_in_Teverina
агидель	Agidel
брун-ан-дер-вильд	Brunn_an_der_Wild
брайслин,миннесота	Bricelyn,_Minnesota
амазено	Amaseno
билина,город	Bílina
боза	Bosa
бигелоу,город	Bigelow,_Minnesota
авадзи,город	Awaji,_Hyōgo
бойсе	Boise,_Idaho
аспанг-маркт	Aspang-Markt
бауладу	Bauladu
абингдон	Abingdon,_Illinois
альварес	Álvarez,_Tamaulipas
батам	Batam
бубьерка	Bubierca
бодетт,город	Baudette,_Minnesota
бивер-бей	Beaver_Bay,_Minnesota
безате	Besate
вертемате-кон-миноприо	Vertemate_con_Minoprio
бафк	Bafq
вилла-бартоломея	Villa_Bartolomea
вильяблино	Villablino
бранд-нагельберг	Brand-Nagelberg
бидар	Bidar
виголо-ваттаро	Vigolo_Vattaro
букан	Bukan
арауко,чили	Arauco,_Chile
барцаго	Barzago
бознаско	Bosnasco
ваяно	Vaiano
бердехо	Berdejo
вилла-дель-конте	Villa_del_Conte
вилабоа	Vilaboa
альенту	Aglientu
американ фолс	American_Falls,_Idaho
борго-вальсугана	Borgo_Valsugana
белланте	Bellante
айсгарн	Eisgarn
бердичев	Berdychiv
вильяминая	Villaminaya
вигано	Viganò
астана	Astana
альтамура	Altamura
андрушёвка	Andrushivka
асколи-пичено	Ascoli_Piceno
бискарруэс	Biscarrués
бадия-калавена	Badia_Calavena
винер-нойдорф	Wiener_Neudorf
барни	Barni
апостолово	Apostolove
витория-ду-жари	Vitória_do_Jari
вальдоббьядене	Valdobbiadene
айвалык	Ayvalık
буонвичино	Buonvicino
боруп,город	Borup,_Minnesota
букс	Buchs,_St._Gallen
бьелла	Biella
вильярроя-де-ла-сьерра	Villarroya_de_la_Sierra
благовещенск,башкортостан	Blagoveshchensk,_Republic_of_Bashkortostan
борго-велино	Borgo_Velino
билина	Bílina
аспендос	Aspendos
бад-клайнкирххайм	Bad_Kleinkirchheim
бенгази	Benghazi
ардино	Ardino
бойд,город	Boyd,_Minnesota
больцано-новарезе	Bolzano_Novarese
бюлах	Bülach
алтус	Altus,_Arkansas
вилламарцана	Villamarzana
вастоджирарди	Vastogirardi
брукпорт	Brookport,_Illinois
бочжоу	Bozhou
бронницы	Bronnitsy
висагинас	Visaginas
валье-де-сантибаньес	Valle_de_Santibáñez
бодональ-де-ла-сьерра	Bodonal_de_la_Sierra
вилямовице	Wilamowice
блейн	Blaine,_Minnesota
висбю	Visby
вольск	Volsk
альтдорф	Altdorf,_Switzerland
арола	Arola
адеркла	Aderklaa
велада	Velada
айка	Ajka
вольбуж	Wolbórz
айова-сити,айова	Iowa_City,_Iowa
бьянки	Bianchi,_Calabria
бартоломеберг	Bartholomäberg
брено,италия	Breno
вильянуэва-де-авила	Villanueva_de_Ávila
анфо	Anfo
биг-фолс,миннесота	Big_Falls,_Minnesota
бид	Beed
битетто	Bitetto
абхар	Abhar
айзенэрц	Eisenerz
азамгарх	Azamgarh
альмендраль-де-ла-каньяда	Almendral_de_la_Cañada
вевис	Vievis
батала	Batala
бандунг	Bandung
абфальтерсбах	Abfaltersbach
вильферсдорф	Wilfersdorf
аличе-кастелло	Alice_Castello
брандико	Brandico
андорно-микка	Andorno_Micca
брайтенштайн,нижняя австрия	Breitenstein,_Lower_Austria
асина	Asine
аюэла	Ayuela
акаива	Akaiwa,_Okayama
вакфыкебир	Vakfıkebir
амброз	Ambrose,_North_Dakota
вила-реал	Vila_Real,_Portugal
боллате	Bollate
альтенбург,австрия	Altenburg,_Lower_Austria
вилла-санта-мария	Villa_Santa_Maria
алегзандрия,миннесота	Alexandria,_Minnesota
виктор-харбор	Victor_Harbor,_South_Australia
акхисар	Akhisar
альвито	Alvito,_Lazio
буроло	Burolo
вердзуоло	Verzuolo
воница	Vonitsa
барсана	Barsana
бальдрамсдорф	Baldramsdorf
василькув	Wasilków
вышогруд	Wyszogród
арвье	Arvier
вальдовиньо	Valdoviño
брайант,арканзас	Bryant,_Arkansas
блаж	Blaj
вильяно-д’асти	Vigliano_d'Asti
велика-горица	Velika_Gorica
банана,республика	Banana,_Democratic_Republic_of_the_Congo
басти	Basti,_Uttar_Pradesh
белла	Bella,_Basilicata
вильодре	Villodre
вальделакаса-де-тахо	Valdelacasa_de_Tajo
балахна	Balakhna
бейпорт,миннесота	Bayport,_Minnesota
анжеро-судженск	Anzhero-Sudzhensk
везиме	Vesime
веккьяно	Vecchiano
аркаде	Arcade,_Veneto
бозио	Bosio
бивер-бей,город	Beaver_Bay,_Minnesota
вьяндар-де-ла-вера	Viandar_de_la_Vera
агуаскальентес	Aguascalientes,_Aguascalientes
акаси,город	Akashi,_Hyōgo
бадами	Badami
вагенинген	Wageningen
ангра-ду-эроишму	Angra_do_Heroísmo
ачэн	Acheng_District
ариэль	Ariel_(city)
бяла-писка	Biała_Piska
баизо	Baiso
веноза	Venosa
аривунимаму	Arivonimamo
бенамехи	Benamejí
бекингем	Buckingham,_Richardson,_Texas
виганелла	Viganella
блэкфут	Blackfoot,_Idaho
будоя	Budoia
вольтерра	Volterra
велинград	Velingrad
баян-нур	Bayannur
боргофорте	Borgoforte
боргорикко	Borgoricco
альварес,тамаулипас	Álvarez,_Tamaulipas
адзельо	Azeglio
вегас-дель-кондадо	Vegas_del_Condado
алмора	Almora
бисимбре	Bisimbre
арендал	Arendal
боволоне	Bovolone
влоцлавек	Włocławek
барки	Barchi,_Marche
альтендорф,австрия	Altendorf,_Austria
беркли,калифорния	Berkeley,_California
батман	Batman,_Turkey
виллессе	Villesse
бадолатоса	Badolatosa
бидзен	Bizen,_Okayama
бад-гойзерн	Bad_Goisern
военный городок	Military_town
бондо	Bondo,_Trentino
валье-де-вальдебесана	Valle_de_Valdebezana
валье-де-самансас	Valle_de_Zamanzas
ахмеднагар	Ahmednagar
адамс,миннесота	Adams,_Minnesota
барипада	Baripada
бухбах	Buchbach,_Austria
брандон	Brandon,_Minnesota
алатри	Alatri
альбеттоне	Albettone
айсанти,миннесота	Isanti,_Minnesota
анникко	Annicco
бохум	Bochum
вальи-сотто	Vagli_Sotto
бельфорте-монферрато	Belforte_Monferrato
вилла-сан-секондо	Villa_San_Secondo
ассен	Assen
вайден-ам-зе	Weiden_am_See
белл-гарденс	Bell_Gardens,_California
батл-лейк,миннесота	Battle_Lake,_Minnesota
арика	Arica
всетин	Vsetín
аидзувакамацу	Aizuwakamatsu,_Fukushima
воломин	Wołomin
вилла-гуардия	Villa_Guardia
беттлс,аляска	Bettles,_Alaska
арта,город	Arta,_Greece
бильче-золотое,борщёвский район	Bilche_Zolote
виллард,город	Villard,_Minnesota
буссо,город	Busso
виль,санкт-галлен	Wil
бина,миннесота	Bena,_Minnesota
аккуаро	Acquaro
блитар,город	Blitar
бонаруйе	Banaruiyeh
барни,комо	Barni
валле-ди-маддалони	Valle_di_Maddaloni
винден-ам-зе	Winden_am_See
аталая-ду-норти	Atalaia_do_Norte
валлетта	Valletta
васильевка,город	Vasylivka
антанифутси	Antanifotsy
айванхо,город	Ivanhoe,_Minnesota
вильяфеличе	Villafeliche
беллицци	Bellizzi
вильямедьянилья	Villamedianilla
буонконвенто	Buonconvento
базильо	Basiglio
валенштадт	Walenstadt
бялобжеги	Białobrzegi
бараноа	Baranoa
аччеттура	Accettura
агбор	Agbor
вэйхай	Weihai
вильядеканес	Toral_de_los_Vados
амавида	Amavida
баски,италия	Baschi
аккуанегра-кремонезе	Acquanegra_Cremonese
вильярехо-дель-валье	Villarejo_del_Valle
баньоло-мелла	Bagnolo_Mella
веронелла	Veronella
айронтон	Ironton,_Minnesota
бьено	Bieno
алегзандрия	Alexandria,_Minnesota
абфальтерсбах,тироль	Abfaltersbach
бульци	Bulzi
бад-фёслау	Bad_Vöslau
барле-хертог	Baarle-Hertog
арденно	Ardenno
вайсенкирхен-ин-дер-вахау	Weißenkirchen_in_der_Wachau
вера-де-монкайо	Vera_de_Moncayo
вольфау	Wolfau
альмонасид-де-ла-сьерра	Almonacid_de_la_Sierra
виго	Vigo
валларса	Vallarsa
бранч	Branch,_Arkansas
влощова	Włoszczowa
борго-д’але	Borgo_d'Ale
арберг	Aarberg
вадул-луй-водэ	Vadul_lui_Vodă
англтон,техас	Angleton,_Texas
асан	Asan
борнаско	Bornasco
вильясандино	Villasandino
базеличе	Baselice
брашов	Brașov
беллвилл,иллинойс	Belleville,_Illinois
бидони	Bidonì
белжице	Bełżyce
варко-сабино	Varco_Sabino
банак	Bank,_Iran
бюзум	Büsum
асеучаль	Aceuchal
вилла-верде	Villa_Verde
брунелло	Brunello,_Lombardy
вальмадрера	Valmadrera
вермеццо	Vermezzo
альфамбра	Alfambra
асти	Asti
вальделугерос	Valdelugueros
адыяман	Adıyaman
альбания	Albania,_La_Guajira
барбадильо-дель-меркадо	Barbadillo_del_Mercado
айзенхюттенштадт	Eisenhüttenstadt
бивертон,орегон	Beaverton,_Oregon
баннио-анцино	Bannio_Anzino
вильяманрике-де-ла-кондеса	Villamanrique_de_la_Condesa
валенса	Valença,_Portugal
брад	Brad,_Hunedoara
брукк-ан-дер-лайта	Bruck_an_der_Leitha
барлинг	Barling,_Arkansas
альтавилла-монферрато	Altavilla_Monferrato
болано	Bolano
вадзима	Wajima,_Ishikawa
вила-реал-де-санту-антониу	Vila_Real_de_Santo_António_(parish)
анголь	Angol
агоста	Agosta,_Lazio
вакаяма,город	Wakayama,_Wakayama
бад-цурцах	Bad_Zurzach
асино	Asino
бельсито	Belsito
борго-тоссиньяно	Borgo_Tossignano
арауко	Arauco,_Chile
аджус	Aggius
вилюйск	Vilyuysk
вегакемада	Vegaquemada
антау	Antau
борджалло	Borgiallo
бриона	Briona
валье-де-лас-навас	Valle_de_las_Navas
брента,город	Brenta,_Lombardy
биккари	Biccari
бишкек	Bishkek
валле-агрикола	Valle_Agricola
вильягарсия-де-ла-торре	Villagarcía_de_la_Torre
броквилл	Brockville
андервуд,город	Underwood,_Minnesota
вальдивия	Valdivia
ампарафаравола	Amparafaravola
виченца	Vicenza
банска-штьявница	Banská_Štiavnica
бейрут	Beirut
валмиера	Valmiera
валланценго	Vallanzengo
бенамаурель	Benamaurel
баббитт,город	Babbitt,_Minnesota
вильяан	Villahán
бареджо	Bareggio
восточный иерусалим	East_Jerusalem
вернон-сентер	Vernon_Center,_Minnesota
балаково	Balakovo
брига-новарезе	Briga_Novarese
белорецк	Beloretsk
богоньо	Bogogno
бемиджи	Bemidji,_Minnesota
велеццо-ломеллина	Velezzo_Lomellina
альбалате-де-синка	Albalate_de_Cinca
вилланова-д’асти	Villanova_d'Asti
аугуста	Augusta,_Sicily
анья	Agna
винкьо	Vinchio
броуэрвилл,миннесота	Browerville,_Minnesota
беломорск	Belomorsk
болград	Bolhrad
ауриго	Aurigo
вабаг	Wabag
анцола-дель-эмилия	Anzola_dell'Emilia
белвидир,иллинойс	Belvidere,_Illinois
вильферсдорф,нижняя австрия	Wilfersdorf
бенд	Bend,_Oregon
брончалес	Bronchales
бистрица	Bistrița
владимир-волынский	Volodymyr-Volynskyi
бургауберг-нойдауберг	Burgauberg-Neudauberg
венсильон	Vencillón
вадокондес	Vadocondes
берг,австрия	Berg,_Lower_Austria
айос-николаос	Agios_Nikolaos,_Crete
ассоло	Assolo
варта,город	Warta,_Poland
алварейдо	Alvarado,_Minnesota
аненто	Anento
вито-д’азио	Vito_d'Asio
альколеа-де-синка	Alcolea_de_Cinca
венеция	Venice
брянка	Brianka
брекенридж	Breckenridge,_Minnesota
аппьяно-джентиле	Appiano_Gentile
бина,город	Bena,_Minnesota
выхма	Võhma
владимир	Vladimir
альбета	Albeta
бакстер,город	Baxter,_Minnesota
бату	Batu_(city)
врлика	Vrlika
атрипальда	Atripalda
альдеасека	Aldeaseca
вильягонсало	Villagonzalo
бенестаре	Benestare
висейлия	Visalia,_California
адамс,город	Adams,_Minnesota
аттимис	Attimis
бад-санкт-леонхард-им-лафантталь	Bad_Sankt_Leonhard_im_Lavanttal
вальдеторрес	Valdetorres
вильяркемадо	Villarquemado
бингхем-лейк,город	Bingham_Lake,_Minnesota
артёмовка,область	Artemivka
березовка,область	Berezivka
бари	Bari
восход	Voskhod,_Moscow_Oblast
вильякиламбре	Villaquilambre
алту-парнаиба	Alto_Parnaíba
амбатулампи	Ambatolampy
вильяррика	Villarrica,_Chile
брикеразио	Bricherasio
власиха,московская область	Vlasikha,_Moscow_Oblast
брушано	Brusciano
аллеге	Alleghe
баньюэлос-де-буреба	Bañuelos_de_Bureba
бам	Bam,_Iran
аццано-д’асти	Azzano_d'Asti
вилланова-монферрато	Villanova_Monferrato
бласконуньо-де-матакабрас	Blasconuño_de_Matacabras
бжостек,город	Brzostek
арсеньев,город	Arsenyev
бендер-дейлем	Bandar_Deylam
волос	Volos
берцо-инфериоре	Berzo_Inferiore
армази,город	Armazi
виноградов	Vynohradiv
асака	Asaka,_Saitama
вщиж	Vshchizh
азнакаево	Aznakayevo
бельмонте-пичено	Belmonte_Piceno
боулус	Bowlus,_Minnesota
браньск	Brańsk
бозизьо-парини	Bosisio_Parini
бирсфельден	Birsfelden
анкоридж	Anchorage,_Alaska
влёра	Vlorë
астане	Astaneh,_Markazi
бртнице,город	Brtnice
вардха	Wardha
боржоми	Borjomi
вайнинг,город	Vining,_Minnesota
агон	Agón
бидхуна	Bidhuna
бахадургарх	Bahadurgarh
бильбао	Bilbao
венаска	Venasca
бадалукко	Badalucco
войенс	Vojens
вустер	Worcester,_Massachusetts
албуфейра	Albufeira
батталья-терме	Battaglia_Terme
аркуа-полезине	Arquà_Polesine
виньоле-борбера	Vignole_Borbera
армо	Armo
вальдкирхен-ан-дер-тайя	Waldkirchen_an_der_Thaya
бэйхай	Beihai
вильярреаль-де-уэрва	Villarreal_de_Huerva
ботроп	Bottrop
баргальи	Bargagli
алфа,миннесота	Alpha,_Minnesota
бассиано	Bassiano
бакленд,аляска	Buckland,_Alaska
винница	Vinnytsia
бургдорф,берн	Burgdorf,_Switzerland
вёнзув	Wiązów
валь-ди-ницца	Val_di_Nizza
бертельсдорф	Berthelsdorf
вайтен,нижняя австрия	Weiten
белгрейд	Belgrade,_Montana
ахваз	Ahvaz
аргайл,миннесота	Argyle,_Minnesota
брайтенау,нижняя австрия	Breitenau,_Lower_Austria
бакман,город	Buckman,_Minnesota
арск	Arsk
вильянуэва-де-карасо	Villanueva_de_Carazo
арборио	Arborio,_Piedmont
байвабик	Biwabik,_Minnesota
алькифе	Alquife
вильямена	Villamena
вальдеррабано	Valderrábano
вильятурде	Villaturde
араусо-де-мьель	Arauzo_de_Miel
болотное	Bolotnoye
барумини	Barumini
барбуэс	Barbués
бердск	Berdsk
адамов,район	Adamov_(Blansko_District)
вилково	Vylkove
венаротта	Venarotta
аккумоли	Accumoli
атуотер	Atwater,_Minnesota
болеславец	Bolesławiec
богумин	Bohumín
воркута	Vorkuta
боттино	Bottineau,_North_Dakota
вильясала	Villazala
бирск	Birsk
биласпур	Bilaspur,_Chhattisgarh
бисаурри	Bisaurri
ашим	Askim
бобова	Bobowa
арсита	Arsita
ассемини	Assemini
беллфлауэр,калифорния	Bellflower,_California
блеса	Blesa
велилья-де-синка	Velilla_de_Cinca
бакстер	Baxter,_Minnesota
вудберн,орегон	Woodburn,_Oregon
веяно	Vejano
волонго	Volongo
банджар,город	Banjar,_West_Java
ванг	Wang,_Austria
баллибофи	Ballybofey
вайтен,австрия	Weiten
альтенмаркт-бай-санкт-галлен	Altenmarkt_bei_Sankt_Gallen
багалкот	Bagalkot
барди	Bardi,_Emilia-Romagna
барбания	Barbania
бармер	Barmer,_Rajasthan
брянск	Bryansk
альгеро	Alghero
агео	Ageo,_Saitama
ванцагелло	Vanzaghello
богданци,город	Bogdanci
ангарск	Angarsk
бендеры	Bender,_Moldova
боргоново-валь-тидоне	Borgonovo_Val_Tidone
баббитт,миннесота	Babbitt,_Minnesota
борго-сан-джакомо	Borgo_San_Giacomo
балдео	Baldeo
вулкан	Vulcan,_Hunedoara
байрон,миннесота	Byron,_Minnesota
баффало-лейк	Buffalo_Lake,_Minnesota
арагуэс-дель-пуэрто	Aragüés_del_Puerto
вильнюс	Vilnius
вахдаттийе	Vahdatiyeh
ацуги	Atsugi,_Kanagawa
бондо,италия	Bondo,_Trentino
блуминг-прери	Blooming_Prairie,_Minnesota
брешиа	Brescia
берг	Berg,_Lower_Austria
аслинг	Assling
вюрфлах	Würflach
борго-верчелли	Borgo_Vercelli
валдиз	Valdez,_Alaska
арчизате	Arcisate
алкобаса	Alcobaça,_Portugal
алькольярин	Alcollarín
аниф	Anif
алачуа	Alachua,_Florida
валлерн	Wallern_im_Burgenland
вудленд	Woodland,_Minnesota
бонассола	Bonassola
борислав,город	Boryslav
боргомазино	Borgomasino
вильяленгуа	Villalengua
альканьисо	Alcañizo
анантапур	Anantapur,_Andhra_Pradesh
али	Alì
бурчеи	Burcei
амвросиевка	Amvrosiivka
бардолино	Bardolino
вилланова-д’арденги	Villanova_d'Ardenghi
бингхем-лейк	Bingham_Lake,_Minnesota
абботсфорд	Abbotsford,_British_Columbia
беас-де-гранада	Beas_de_Granada
беслан	Beslan
беркидда	Berchidda
видяево	Vidyayevo
вильянуэва-де-ла-сьерра	Villanueva_de_la_Sierra
брец	Brez
берли,айдахо	Burley,_Idaho
абу-эль-хасиб	Abu_Al-Khaseeb
бардо,воеводство	Bardo,_Poland
альберта,миннесота	Alberta,_Minnesota
бросас	Brozas
бухбах,нижняя австрия	Buchbach,_Austria
аншан	Anshan_(Persia)
вильянуэва-де-ла-хара	Villanueva_de_la_Jara
аппиньяно-дель-тронто	Appignano_del_Tronto
вайнинг	Vining,_Minnesota
амандола	Amandola
вильясаррасино	Villasarracino
аппингедам	Appingedam
беналуа	Benalúa
альтхайм,верхняя австрия	Altheim,_Austria
вуктыл	Vuktyl
бельпассо	Belpasso
аспен,колорадо	Aspen,_Colorado
арбус,сардиния	Arbus,_Sardinia
баотоу	Baotou
буе,хорватия	Buje
буссеро	Bussero
альта-виста	Alta_Vista,_Ottawa
валера-фратта	Valera_Fratta
баньоло-ди-по	Bagnolo_di_Po
баргас	Bargas
буэнья	Bueña
боровичи	Borovichi
биржай	Biržai
борго-сан-лоренцо	Borgo_San_Lorenzo
анкарано	Ancarano
бигарелло	Bigarello
вильясабарьего	Villasabariego
бельведере-ди-спинелло	Belvedere_di_Spinello
альба-де-серрато	Alba_de_Cerrato
апсала,миннесота	Upsala,_Minnesota
бельвилл	Belleville,_Arkansas
вичуга	Vichuga
вильявисьоса-де-кордова	Villaviciosa_de_Córdoba
апамея,сирия	Apamea,_Syria
будони	Budoni
виллетта-барреа	Villetta_Barrea
ареополис	Areopoli
бреньяно	Bregnano
аркадия,калифорния	Arcadia,_California
вилючинск	Vilyuchinsk
амбанья	Ambanja
вельке слеменце	Veľké_Slemence
видлисбах	Wiedlisbach
ачи-сант-антонио	Aci_Sant'Antonio
бояно	Bojano
брафим	Bràfim
асака,япония	Asaka,_Saitama
анк-морпорк	Ankh-Morpork
боадилья-де-риосеко	Boadilla_de_Rioseco
вильялобон	Villalobón
блафтон,город	Bluffton,_Minnesota
альбидзате	Albizzate
адаб	Adab_(city)
альфьянелло	Alfianello
брасакорта	Brazacorta
бассано-романо	Bassano_Romano
бордзонаска	Borzonasca
борги	Borghi
аккуарика-дель-капо	Acquarica_del_Capo
визельбург-ланд	Wieselburg-Land
баакуба	Baqubah
бридж-сити	Bridge_City,_Texas
бурета	Bureta
бишофштеттен	Bischofstetten
вэньчан	Wenchang
валлориате	Valloriate
аньда	Anda,_Heilongjiang
бардже	Barge,_Piedmont
бирдсли,миннесота	Beardsley,_Minnesota
афтон,миннесота	Afton,_Minnesota
вальдидентро	Valdidentro
баньоло-сан-вито	Bagnolo_San_Vito
бибьяна	Bibiana,_Piedmont
амаранти	Amarante,_Portugal
коммуна бренна	Brenna,_Lombardy
альбонезе	Albonese
аспиндза	Aspindza
вильякехида	Villaquejida
высока	Wysoka
вилладеати	Villadeati
вулф-лейк	Wolf_Lake,_Minnesota
виадана	Viadana,_Lombardy
биллунн	Billund,_Denmark
альколеа-де-тахо	Alcolea_de_Tajo
вавилон	Babylon
бетел-хайтс,арканзас	Bethel_Heights,_Arkansas
биольо	Bioglio
виджанелло,италия	Viggianello
вольфсталь	Wolfsthal
вильяйерно-моркильяс	Villayerno_Morquillas
бойковице	Bojkovice
бароло	Barolo,_Piedmont
аллайанс,небраска	Alliance,_Nebraska
бомдила	Bomdila
баньяско	Bagnasco
борзна	Borzna
броуэрвилл	Browerville,_Minnesota
визианагарам	Vizianagaram
бультеи	Bultei
азильяно-верчеллезе	Asigliano_Vercellese
ванье	Vanier,_Ontario
березовка	Berezivka
браунсдейл,город	Brownsdale,_Minnesota
апиче	Apice
бортиджадас	Bortigiadas
боннанаро	Bonnanaro
амброз,дакота	Ambrose,_North_Dakota
боргофранко-д’ивреа	Borgofranco_d'Ivrea
брукстон,город	Brookston,_Minnesota
вермильо	Vermiglio
буэна-парк,калифорния	Buena_Park,_California
бровары	Brovary
браунтон	Brownton,_Minnesota
бунготакада	Bungotakada,_Ōita
валье-де-мансанедо	Valle_de_Manzanedo
вальверде-де-ла-вера	Valverde_de_la_Vera
балатон	Balaton,_Minnesota
аомори	Aomori,_Aomori
анкуд	Ancud
ассалуйе	Asaluyeh
алар-дель-рей	Alar_del_Rey
беч	Biecz
анцирабе	Antsirabe
берлангас-де-роа	Berlangas_de_Roa
бехарестан	Baharestan,_Isfahan
баворов	Bavorov
борго-сан-мартино	Borgo_San_Martino
вайкерсдорф-ам-штайнфельде	Weikersdorf_am_Steinfelde
веллеццо-беллини	Vellezzo_Bellini
баттерфилд	Butterfield,_Minnesota
бигфорк	Bigfork,_Minnesota
броуэрвилл,город	Browerville,_Minnesota
вильоруэбо	Villoruebo
варанаси	Varanasi
богатыня	Bogatynia
вильянуэва-дель-ребольяр-де-ла-сьерра	Villanueva_del_Rebollar_de_la_Sierra
виколи	Vicoli
бьона	Bionaz
величка	Wieliczka
валбжих	Wałbrzych
волочиск	Volochysk
аркуа-петрарка	Arquà_Petrarca
араменго	Aramengo
аньяна-калабра	Agnana_Calabra
винкьятуро	Vinchiaturo
авелла	Avella
бока-ратон	Boca_Raton,_Florida
аоста	Aosta
велюнь	Wieluń
александрия кавказская	Alexandria_on_the_Caucasus
бабахейдар	Babaheydar
баттифолло	Battifollo
ачалда	Achhalda
вайдхофен-ан-дер-тайя-ланд	Waidhofen_an_der_Thaya-Land
блафтон	Bluffton,_Minnesota
вулвертон,город	Wolverton,_Minnesota
вердзеньис	Verzegnis
веттинген	Wettingen
будё	Bodø
алькофен,австрия	Alkoven
брессана-боттароне	Bressana_Bottarone
альтиволе	Altivole
