драва,хорватия,мута (словения)	Drava
земенбах,,	Seemenbach
зальце,,	Salze_(Bega)
дравиня,,	Dravinja
грона,,	Grosne_(river)
олше,,	Olza_(river)
финтау,,	Fintau
варта,,	Warta
зур,река,,	Sur_(river)
гоаскоран,сальвадор,	Goascorán_River
сарата,река,,	Sarata_River
брагинка,,	Braginka_River
розенауэ,,	Rosenaue
большая золотанка,,	Bolshaya_Zolotanka_River
аныль,,	Anyl_River
уржумка,река,,	Urzhumka_River
кноллербах,,	Knollerbach
эрнц-бланхе,,	White_Ernz
березайка,река,,	Berezayka_River
огрже,,	Ohře
гиль,река,,	Guil
броадкилл,соединённые штаты америки,	Broadkill_River
траун,река,,	Traun_(river)
б,река,румыния,ечка,зренянин,фэджет,тимишоара,рекаш	Bega_River,_Romania_and_Serbia
харьков,река,,	Kharkiv_River
большой чабис,,	Bolshoy_Chabes_River
тахо,река,португалия,	Tagus
мапуту,река,мозамбик,	Maputo_River
агу,река,,	Agout
флатхед,река,,	Flathead_River
нотване,ботсвана,	Notwane_River
уилламетт,лейн (округ, орегон),	Willamette_River
саскачеван,река,,	Saskatchewan_River
хондерфельдбах,,	Hohnderfeldbach
бобрич,река,,	Bobritzsch_(river)
чит,река,соединённые штаты америки,	Cheat_River
аббабах,,	Abbabach
коксоак,канада,	Koksoak_River
шоша,,	Shosha_River
меттер,,	Metter_(river)
асфе,,	Asphe
шильтах,река,,	Schiltach_(river)
райхенбехле,,	Reichenbächle_(Schiltach)
албион,река,соединённые штаты америки,	Albion_River
большая хета,,	Bolshaya_Kheta_River
венкбах,,	Wenkbach_(Lahn)
кутим,,	Kutim_River
патсойоки,,	Paatsjoki
рауэ,,	Rahue_River
кванго,ангола,	Kwango_River
гёттхесбах,,	Göttchesbach
иппари,,	Ippari
андома,,	Andoma_River
мундо,река,,	Mundo_(river)
яугила,,	Jaugila
россель,река,,	Rossel_(Saar)
линдах,,	Lindach
тихвинка,река,,	Tikhvinka_River
волчина,,	Volchina_River
тирбах,река,,	Thierbach
труппах,,	Truppach_(Wiesent)
литл-колорадо,уайт-маунтинс (аризона),	Little_Colorado_River
мельббах,,	Melbbach
могами,река,япония,	Mogami_River
мопан,,	Mopan_River
стоход,река,,	Stokhid_River
була,река,,	Bula_River
кифербах,,	Kieferbach
с,река,польша,	San_(river)
дрин,республика косово,	Drin_(river)
свете,,	Svete_(river)
зубра,река,,	Zubra_River
шошма,,	Shoshma_River
бурбенса,,	Bourbince
хенсбах,,	Hensbach
сезия,,	Sesia
большой цивиль,,	Tsivil_River
вурм,река,,	Wurm
логен,,	Numedalslågen
вятка,река,,	Vyatka_River
кокосинг,,	Kokosing_River
палана,река,,	Palana_River
пякупур,,	Pyakupur_River
бросна,,	River_Brosna
кник,река,,	Knik_River
джордж,река,,	George_River_(Quebec)
ваал,река,нидерланды,горинхем,неймеген,тил,залтбоммел	Waal_(river)
одра,польша,	Oder
кагальник,река,впадает в азовское море,,	Kagalnik_River
кайахога,,	Cuyahoga_River
санта-ана,река,,риверсайд (калифорния),сан-бернардино (калифорния),санта-ана (калифорния)	Santa_Ana_River
голлах,,	Gollach
визе,река,,	Wiese
западный буг,белоруссия,	Bug_River
энца,,	Enza
оркла,река,,	Orkla_(river)
ока,,	Oka_River
дальке,,	Dalke
малый кундыш,,	Maly_Kundysh_River
таг-форк,соединённые штаты америки,	Tug_Fork
б,река,соединённые штаты америки,beaver falls, pennsylvania,bridgewater, pennsylvania,rochester, pennsylvania	Beaver_River_(Pennsylvania)
гауя,,	Gauja
м,река,канада,	Madawaska_River_(Ontario)
кройцбах,,	Kreuzbach_(Erlenbach)
большой заб,иракский курдистан,амедия	Great_Zab
сиксаола,панама,	Sixaola_River
вюмме,,	Wümme
двиница,,	Dvinitsa_River
хегбрюккербах,,	Heegbrückerbach
варк,река,,	Wark_(river)
редвуд-крик,,orick, california	Redwood_Creek_(Humboldt_County)
вурцахер-ах,,	Wurzacher_Ach
алсек,,	Alsek_River
гёцингер-ахен,,	Götzinger_Achen
рио-гранде,река,огненная земля,,	Río_Grande_(Tierra_del_Fuego)
ковжа,река,впадает в белое озеро,,	Kovzha_River
аглуона,,	Agluona_(Akmenė)
шварценбах,река,,	Schwarzenbach_(Obere_Argen)
казан,река,канада,	Kazan_River
рода,река,,	Roda_(river)
жер,река,,	Gers_(river)
каулиц,река,соединённые штаты америки,packwood, washington,mossyrock, washington,randle, washington,kelso, washington,toledo, washington,castle rock, washington,longview, washington	Cowlitz_River
дилль,река,,	Dill_(river)
паранаиба,река,,	Paranaíba_River
иртинг,,	River_Irthing
паранапанема,река,,	Paranapanema_River
мессояха,,	Messoyakha_River
добрах,,	Dobrach
п,река,,	Poltva_River
супрасль,река,,	Supraśl_(river)
подкаменная тунгуска,,	Podkamennaya_Tunguska_River
лор,река,,	Lohr_(river)
куробэ,река,япония,	Kurobe_River
пелли,река,канада,фаро	Pelly_River
ашберн,англия,	River_Ashburn
алагнак,,	Alagnak_River
непа,река,,	Nepa_River
нисте,река,,	Nieste_(river)
южная морава,,	South_Morava
кельбке,,	Kelbke
аланд,река,,	Aland_(river)
уяс,,	Uyas_River
брахт,,	Bracht_(river)
игуасу,река,аргентина,	Iguazu_River
неккар,,	Neckar
беттенбах,,	Bettenbach
раздольная,река,,	Razdolnaya_River
уиллс-крик,,	Wills_Creek_(Ohio)
тура,река,россия,туринск,верхотурье,тюмень,нижняя тура,верхняя тура	Tura_River
джаланги,индия,кришнанагар	Jalangi_River
накнек,река,,	Naknek_River
тапти,река,индия,бурханпур,нандурбар,сурат	Tapti_River
велека,,	Veleka
канал дунай — чёрное море,румыния,румыния,чернаводэ,меджидия,мурфатлар,нэводари,овидиу	Danube–Black_Sea_Canal
эр,река,великобритания,,	River_Aire
нор,река,,	River_Nore
хольцапе,,	Holzape
ферс,река,,	Vers_(river)
прин,река,,	Prien_(river)
орнен,река,,	Ornain
летаба,южно-африканская республика,	Letaba_River
карадарья,киргизия,	Kara_Darya
зенденер-бах,,	Sendener_Bach
нособ,ботсвана,	Nossob_River
оденсе-о,,	Odense_River
шаранта,река,,	Charente_(river)
дорнмюленбах,,	Dornmühlenbach
суситна,река,,	Susitna_River
ворма,,	Vorma
канзас,река,,	Kansas_River
кирбах,,	Kirbach_(river)
а,река,соединённые штаты америки,	American_River_(Washington)
вольта,река,гана,	Volta_River
биг-сэнди,соединённые штаты америки,	Big_Sandy_River_(Ohio_River)
серио,река,,	Serio_(river)
сантри,река,,	Santry_River
барроу,река,ирландия,	River_Barrow
зауренбах,,	Hover_Bach
варнов,,	Warnow
хоппнер,река,,	Hoppner_River
скайкомиш,,	Skykomish_River
шмибах,,	Schmiehbach
эрбштром,,	Erbstrom
вельплагебах,,	Welplagebach
ниолс,,	Niols_River
балцаиа,венгрия,	Balcaia_River
териберка,река,,	Teriberka_River
гнилец,река,,	Hnilec_(river)
бюэш,,	Buëch
аялон,река,израиль,тель-авив,рамат-ган	Ayalon_River
храми,азербайджан,	Khrami
иц,река,,	Itz
выг,россия,беломорск	Vyg_River
конкорд,река,,	Concord_River
йёкюльсау-ау-даль,исландия,	Jökulsá_á_Dal
муцбах,,	Mutzbach
валапаттанам,,	Valapattanam_River
муониоэльвен,финляндия,	Muonio_(river)
ондава,,	Ondava
фаульбах,река,,	Faulbach_(Main)
пилица,река,польша,	Pilica_(river)
кришул-репеде,венгрия,алешд,орадя	Crișul_Repede_River
северная двина,,	Northern_Dvina_River
мама,река,,	Mama_River
ранельва,норвегия,му-и-рана	Ranelva
н,река,россия,	Nera_River_(Russia)
кугарок,сьюард (полуостров),	Kougarok_River
горынь,,	Horyn_River
кларе,река,,	Clarée
ламбро,,	Lambro
ё,река,,	Yelva_River
илиссос,греция,	Ilisos
сиги,река,,	Zigi_River
дигул,индонезия,	Digul
виндвеэ,,	Windwehe
манингури,мадагаскар,ampasina maningory	Maningory_River
плим,река,,	River_Plym
айтценбах,,	Aitzenbach
панаро,река,,	Panaro_(river)
бломбах,,	Blombach
вербе,,	Werbe_(Eder)
пыльтсамаа,река,,	Põltsamaa_(river)
кеннет,река,уилтшир,ньюбери (англия)	River_Kennet
арустук,река,,	Aroostook_River
фрейзер,река,канада,	Fraser_River
рашен-ривер,,хилдсбург,юкайа (калифорния)	Russian_River_(California)
сырдарья,казахстан,кызылорда,худжанд,ташкент,туркестан (город),байконур (город)	Syr_Darya
трубеж,река,впадает в плещеево озеро,,	Trubezh_River
эспер,,	Ösper
бенфе,,	Benfe_(Eder)
коппер,,	Copper_River_(Alaska)
вьоса,,	Aoös
лоссе,река,,	Losse_(river)
нельтуме,река,,	Neltume_River
абакашис,бразилия,	Abacaxis_River
кема,река,впадает в белое озеро,,	Kema_River
сан-франсиску,бразилия,	São_Francisco_River
збечницкий ручей,чехия,гронов,збечник	Zbečník_stream
карбах,,	Karbach_(Main)
напте,,	Napte
флаттенер-бах,,	Vlattener_Bach
колвилл,река,соединённые штаты америки,	Colville_River_(Alaska)
саксагань,украина,кривой рог	Saksahan
потенца,река,,	Potenza_(river)
лирбах,,	Lierbach
джеймс,река,соединённые штаты америки,	James_River
важинка,,	Vazhinka_River
йиде-эльв,швеция,	Gide_River
ильсбах,,	Ilsbach_(Seenbach)
шире,река,малави,	Shire_River
репруа,грузия,	Reprua_River
днестр,,	Dniester
альмендарес,,	Almendares_River
аула,река,,	Aula_(river)
гауангельбах,,	Gauangelbach
рейн,королевство франция,	Rhine
лотта,,	Lutto_(river)
эссельбах,река,,	Esselbach_(Salwey)
нармада,река,индия,махешвар,бхаруч,девас,джабалпур,раджпипла,омкарешвар	Narmada_River
тахунья,испания,	Tajuña
худосей,,	Khudosey_River
ветшафт,,	Wetschaft
кунар,река,афганистан,	Kunar_River
суда,река,впадает в рыбинское водохранилище,,	Suda_River
деренбах,,	Derenbach_(Bröl)
минданао,река,филиппины,валенсия (филиппины)	Rio_Grande_de_Mindanao
брег,,	Breg_(river)
хазе,германия,оснабрюк,берзенбрюк,брамше,эссен (ольденбург),хазелюнне,херцлаке,лёнинген,меппен,квакенбрюк	Hase
западная двина,,	Daugava_(river)
цидлина,,	Cidlina
увац,,	Uvac
карсон,река,,	Carson_River
кессах,,	Kessach
а,река,киргизия,	Ak-Suu_River_(Chu)
айдер,река,,	Eider_(river)
левуо,,	Lėvuo
мензеля,,	Menzelya_River
сил,река,канада,	Seal_River_(Manitoba)
мёша,,	Myosha_River
штрасбах,,	Straßbach
рио-ондо,,	Hondo_River_(Belize)
кюртенер-зюльц,,	Kürtener_Sülz
журуа,,	Juruá_River
шилка,,	Shilka_River
еруслан,река,,	Yeruslan_River
ауфзес,река,,	Aufseß_(river)
геннах,река,,	Gennach
соррайя,река,португалия,	Sorraia_River
синни,,	Sinni_(river)
кёрёш,венгрия,бекеш (город),сарваш	Körös_River
риенца,,	Rienz
зай,река,,	Zay_River
гаскойн,река,австралия,	Gascoyne_River
ди,река,впадает в северное море,шотландия,	River_Dee,_Aberdeenshire
волхов,россия,волхов (город),кириши,новая ладога,великий новгород	Volkhov_River
рёума,река,,	Rauma_(river)
белиз,река,,	Belize_River
мехреньга,,	Mekhrenga_River
литл-саскачеван,,	Little_Saskatchewan_River
амель,река,,	Amblève_(river)
дюльбах,,	Dühlbach
мюльмиш,,	Mülmisch
богота,река,,	Bogotá_River
фёй,река,канада,	Leaf_River_(Quebec)
сытке,,	Sõtke_(river)
сегре,река,,	Segre_(river)
энс,река,,	Enns_(river)
лайтцах,,	Leitzach
пираньяс,река,бразилия,	Piranhas_River
стикс,река,тасмания,,	Styx_River_(Tasmania)
волга,россия,астрахань,казань,нижний новгород,самара,саратов,тверь,ульяновск,волгоград,ярославль	Volga_River
потомак,соединённые штаты америки,александрия (виргиния),арлингтон (округ, виргиния),вашингтон (округ колумбия)	Potomac_River
йи,река,,	Yí_River
льянкиуэ,река,,	Llanquihue_River
линде,река,,	Linde_River
сейм,река,,	Seym_River
ванбах,,	Wahnbach
эрфт,,	Erft
сефидруд,иран,	Sefīd-Rūd
тауи,река,,кармартен	River_Towy
йом,река,таиланд,	Yom_River
сейль-эз-зарка,иордания,амман,джараш,эз-зарка	Zarqa_River
френч-ривер,канада,	French_River_(Ontario)
магдалена,река,колумбия,онда (толима)	Magdalena_River
рашка,река,,	Raška_(river)
дора-бальтеа,,	Dora_Baltea
лезум,германия,бремен	Lesum
уршпринг,,	Urspring_(Ach)
штарцель,,	Starzel_(Neckar)
фехте,,	Vechte
мже,чехия,	Mže
и,река,,	Itter_(Rhein)
геле,,	Gehle
хергстбах,,	Hergstbach
кияук,,	Kiyauk_River
крульсбах,,	Krullsbach
ирпень,река,,	Irpin_River
пяндж,,	Panj_River
нёлленбергер-бах,,	Nöllenberger_Bach
белт-крик,,	Belt_Creek_(Montana)
косьва,,	Kosva_River
анкобра,гана,	Ankobra_River
эльзебах,,	Elsebach
браубах,река,,	Braubach_(Liederbach)
аржанс,река,,	Argens
патия,река,,	Patía_River
махананда,бангладеш,	Mahananda_River
кембах,,	Kembach_(Main)
штромбах,,	Strombach_(Agger)
кандер,река,впадает в тунское озеро,швейцария,	Kander_(Switzerland)
гильбах,,	Gillbach
ульстер,река,,	Ulster_(river)
сарстун,,	Sarstoon_River
лерма,река,,	Lerma_River
тибр,,	Tiber
остшайдер-бах,,	Ostscheider_Bach
атабаска,река,канада,	Athabasca_River
шварце-лаутер,,	Black_Lauter
бигхорн,река,,	Bighorn_River
аллен,река,,	Allaine_(river)
эцталер-ахе,,	Ötztaler_Ache
гундбах,,	Gundbach
ремс,,	Rems
олбани,река,канада,	Albany_River
бырлад,река,румыния,васлуй,бырлад,текуч	Bârlad_River
рио-гранде,река,впадает в мексиканский залив,мексика,	Rio_Grande
дордонь,река,,	Dordogne_(river)
обва,,	Obva_River
ядар,,	Jadar_(Drina)
репабликан,,	Republican_River
биа,кот-д’ивуар,	Bia_River
вирвите,,	Virvytė
папалоапан,мексика,	Papaloapan_River
моша,,	Mosha_River
вальдангельбах,,	Waldangelbach
кондурча,,	Kondurcha_River
айфгенбах,,	Eifgenbach
х,река,,	Holzbach_(Usa)
рона,франция,	Rhône
киевка,река,впадает в японское море,,	Kiyevka_River
сун-коси,,	Sun_Kosi
гдовка,,	Gdovka_River
амедичи,,	Amedichi_River
шпре,,	Spree
иййоки,река,впадает в балтийское море,,	Iijoki
акчим,,	Akchim_River
мараньон,перу,	Marañón_River
шмуттер,,	Schmutter
зильбербах,,	Silberbach_(Heubach)
пуста,река,,	Pusta_River_(South_Morava)
аллаиха,,	Allaikha_River
буш,река,северная ирландия,бушмилс	River_Bush
кайнах,,	Kainach_(Wiesent)
румбах,ручей,	Rumbach_(Ruhr)
такуарембо,река,,	Tacuarembó_River
гвадаррама,река,,	Guadarrama_(river)
крабах,,	Krabach
штайнебах,река,,	Steinebach_(Kinzig)
большая кумина,,	Bolshaya_Kumina_River
расина,,	Rasina_(river)
регниц,,	Regnitz
арв,,	Arve
липпингхаузер-бах,,	Lippinghauser_Bach
роттах,,	Rottach_(Iller)
селенга,,	Selenga_River
марджери,река,,	Margaree_River
шлойзе,,	Schleuse_(river)
калм,река,англия,	River_Culm
шписбах,,	Spießbach_(Nidder)
айвишак,,	Ivishak_River
рио-дульсе,река,впадает в карибское море,,	Dulce_River_(Guatemala)
грюнбах,,	Grünbach_(Tauber)
тиса,венгрия,	Tisza
падма,,	Padma_River
дюссель,,	Düssel
к,река,,	Kuta_River
ачанковил,,	Achankovil
з,река,,	Sulzbach_(Nidda)
к,река,айдахо (округ, айдахо),льюистон (айдахо)	Clearwater_River_(Idaho)
охота,река,,	Okhota_River
гальего,река,,	Gállego_(river)
крёз,река,,	Creuse_(river)
флёрсбах,,	Flörsbach_(Lohr)
рамхольцер-вассер,,	Ramholzer_Wasser
каслтаун,река,,	Castletown_River
яренга,,	Yarenga_River
любосеевка,россия,фрязино	Lyuboseyevka_River
тулпан,,	Tulpan_River
хёрстер-бах,,	Hörster_Bach
мес,,	Mess_(river)
г,река,соединённые штаты америки,грин-ривер (вайоминг)	Green_River_(Colorado_River)
хюрбе,,	Hürbe
клайне-эльстер,,	Kleine_Elster
друть,,	Drut_River
ралья,,	Ralja_(river)
катунь,россия,	Katun_River
сак,река,,	River_Suck
уир,река,англия,дарем,сандерленд	River_Wear
вьенна,река,,	Vienne_(river)
нкуси,уганда,	Nkusi_River
эфтер-бах,,	Oefter_Bach
ривьер-де-миль-иль,,	Rivière_des_Mille_Îles
мерсед,река,мадера (округ),el portal, california,livingston, california	Merced_River
евфрат,ирак,	Euphrates
уурэ-гол,монголия,	Üür_River
пиксвагер-бах,,	Pixwaager_Bach
теннесси,река,,	Tennessee_River
буксах,,	Buxach_(Iller)
нёне,река,,	Neuné
годавари,индия,нандер,насик,низамабад (телангана),раджамандри	Godavari_River
инн,река,,	Inn_(river)
блеон,,	Bléone
рёр,река,,	Röhr_(river)
эйвон,река,впадает в ла-манш,уилтшир,	River_Avon,_Hampshire
мадисон,река,,	Madison_River
пилчак,река,,snohomish, washington,granite falls, washington	Pilchuck_River
калавон,,	Calavon
од,река,,	Aude_(river)
глухая вильва,,	Glukhaya_Vilva_River
сота,,	Sota_River
шпрунгбах,,	Sprungbach
рю-де-ма,,	Rupt_de_Mad
линнепе,,	Linnepe_(Röhr)
ториса,,	Torysa_(river)
каракаш,река,,	Karakash_River
тодбах,,	Todbach
димель,,	Diemel
хайденбах,,	Heidenbach
джефферсон,река,,	Jefferson_River
ом,река,,	Ohm_(river)
коюкук,река,,аллакакет (аляска),беттлс (аляска),эвансвилл (аляска),хьюс (аляска),хуслия (аляска)	Koyukuk_River
сакмара,,	Sakmara_River
бхаратапужа,индия,	Bharathappuzha
зефе,,	Seeve
лисварта,,	Liswarta
ампква,река,соединённые штаты америки,	Umpqua_River
перл,река,,	Pearl_River_(Mississippi–Louisiana)
симаррон,река,симаррон (округ, оклахома),кушинг (оклахома)	Cimarron_River_(Arkansas_River)
гордон,река,тасмания,,	Gordon_River
лизер,река,,	Lieser_(river)
кола,река,,	Kola_River
малый иргиз,,	Maly_Irgiz_River
литл-теннесси,джорджия,	Little_Tennessee_River
ч,река,,	Chyornaya_River
аннаполис,река,,	Annapolis_River
друзель,,	Drusel
сигуэла,,	Cigüela
центбах,,	Zentbach
уэнатчи,река,,	Wenatchee_River
зёстбах,,	Soestbach
колумбия,река,,астория (орегон),портленд (орегон),ванкувер (вашингтон)	Columbia_River
фолья,,	Foglia
потенжи,река,бразилия,	Potenji_River
псоу,река,,	Psou_River
мёне,,	Möhne
ривьер-де-прери,,	Rivière_des_Prairies
ловать,,	Lovat_River
керспе,,	Kerspe
бушо,река,,	Bouchot
мезенская пижма,,	Mezenskaya_Pizhma_River
г,река,,	Wild_Gutach
моравска-дие,,	Moravian_Thaya
арно,река,впадает в лигурийское море,,	Arno
пил,река,канада,	Peel_River_(Canada)
фьер,река,,	Fier_(river)
меэ,,	Mehe
шиффлахе,,	Schifflache
нистер,река,,	Nister_(river)
грубе,ручей,	Grube_(Weser)
сясь,,	Syas_River
марпе,,	Marpe_(Salwey)
хатт,река,,	Hutt_River_(New_Zealand)
фойл,северная ирландия,дерри,страбан	River_Foyle
тетерев,река,,	Teteriv_River
блава,словакия,	Blava
уэст-форк,река,соединённые штаты америки,	West_Fork_River
шелберн,река,,	Shelburne_River
изер,река,впадает в северное море,,	Yser
тромбетас,бразилия,	Trombetas_River
кемниц,река,,	Chemnitz_(river)
р,река,соединённые штаты америки,	Rock_River_(Big_Sioux_River)
кильфербах,,	Kilverbach
оттер-крик,река,,ратленд (вермонт)	Otter_Creek_(Vermont)
альма,,	Alma_River_(Crimea)
ингури,,	Inguri_River
умгени,южно-африканская республика,	Umgeni_River
бевера,,	Bévéra
гравона,,	Gravona
клингенграбен,,	Klingengraben
вефсна,норвегия,мушёэн	Vefsna
стрый,река,украина,	Stryi_River
оирасэ,река,,	Oirase_River
керулен,монголия,	Kherlen_River
айзак,,	Eisack
флумендоса,,	Flumendosa
бойн,,	River_Boyne
деруэнт,река,тасмания,австралия,хобарт,нью-норфолк (тасмания)	River_Derwent_(Tasmania)
малый черемшан,,	Maly_Cheremshan_River
ижора,река,,	Izhora_River
дункан,река,,	Duncan_River
куогги,,	River_Quaggy
фольках,река,,	Volkach_(river)
телесбах,,	Tälesbach
койва,,	Koyva_River
хённе,,	Hönne
пас,река,испания,	Pas_(river)
хёршбах,,	Hörschbach
айх,,	Aich_(river)
дойтерграбен,,	Deutergraben
полуй,,	Polui_River
сент-джон,река,квебек,сент-джон (нью-брансуик)	Saint_John_River_(Bay_of_Fundy)
свирь,река,,	Svir_River
трубах,,	Trubach
торса,река,бутан,	Torsa_River
йорк,река,соединённые штаты америки,	York_River_(Virginia)
кеннебек,река,,	Kennebec_River
моравица,,	Golijska_Moravica
дудх-коси,,	Dudh_Kosi
хабур,сирия,рас-эль-айн,эль-хасака	Khabur_River
зимняя золотица,,	Zolotitsa_River
авонбег,,	River_Avonbeg
гаульбах,,	Gaulbach
маханади,индия,сонепур	Mahanadi
атрай,река,бангладеш,	Atrai_River
ха-чу,,	Ha_Chhu
мудыль,,	Mudyl_River
чесма,река,,	Česma
в,река,,лампанг	Wang_River
лупче-савино,река,россия,	Lupche-Savino_River
дешут,дейшут (округ, орегон),	Deschutes_River_(Oregon)
ферзе,,	Verse_(river)
лодденбах,,	Loddenbach
нарын,река,киргизия,кара-куль,таш-кумыр,нарын,нарынская область,джалал-абадская область	Naryn_River
скулкилл,река,соединённые штаты америки,филадельфия,рединг (пенсильвания)	Schuylkill_River
хауптграбен,,	Haggraben
инноко,,	Innoko_River
ремерло-меннигхюффер-мюленбах,,	Rehmerloh-Mennighüffer_Mühlenbach
дюте,,	Düte
имонт,,	River_Eamont
северная кельтма,,	North_Keltma_River
оттава,река,оттава (квебек),	Ottawa_River
мяркис,,	Merkys
барл,англия,	River_Barle
эксплойтс,канада,	Exploits_River
хрудимка,чехия,	Chrudimka
шожма,,	Shozhma_River
писа,,	Pisa_(river)
загебах,,	Sagebach
шпёль,,	Spöl
кашинка,река,,	Kashinka_River
го,река,,	Gōnokawa_River
гуадальмедина,,	Guadalmedina
лашва,,	Lašva
тигр,река,ирак,багдад,мосул,диярбакыр	Tigris
аура,река,,	Aura_(Sinn)
ахер,река,,	Acher
гранд-ривер,река,впадает в эри,,	Grand_River_(Ontario)
сан-хасинто,река,риверсайд (округ),лейк-элсинор,перрис,сан-джасинто	San_Jacinto_River_(California)
хоби,река,,	Khobi_(river)
тольтен,река,,	Toltén_River
пампанга,река,филиппины,кабанатуан	Pampanga_River
ланценбах,,	Lanzenbach_(Weißach)
пёза,,	Pyoza_River
арджеш,река,румыния,олтеница,куртя-де-арджеш,питешти	Argeș_River
касикьяре,венесуэла,	Casiquiare_canal
лепона,,	Liepona
уонгануи,река,,	Whanganui_River
шуттер,,	Schutter_(Kinzig)
бос,река,,	Bos_(Nahe)
гумиста,река,,	Gumista_River
житава,,	Žitava_(river)
печора,река,россия,нарьян-мар,печора (город),усть-цильма	Pechora_River
урзельбах,,	Urselbach
янабах,,	Jahnabach
вильня,,	Vilnia_River
нан,река,таиланд,нан,пхичит,накхонсаван,пхитсанулок,уттарадит	Nan_River
юг,река,,	Yug_River
бымок,,	Bymok_River
дымбовица,румыния,бухарест	Dâmbovița_River
гудено,дания,	Gudenå
нарочь,река,,	Narach_River
кьезе,,	Chiese_(river)
чиливунг,индонезия,богор,депок,джакарта	Ciliwung
тертер,река,нагорно-карабахская республика,барда (город),тертер (город),мартакертский район,мардакерт	Tartar_(river)
улс,,	Uls_River
холстон,река,виргиния,	Holston_River
эльзенц,,	Elsenz
язьва,,	Yazva_River
вуокса,река,,	Vuoksi_River
лжа,,	Ludza_River
зальцах,,	Salzach
риди-крик,соединённые штаты америки,	Reedy_Creek_(West_Virginia)
чулышман,,	Chulyshman_River
хафенлор,река,германия,	Hafenlohr_(river)
риндербах,,	Rinderbach_(Ruhr)
эдер,,	Eder
сент-фрэнсис,река,соединённые штаты америки,farmington, missouri	St._Francis_River
снохомиш,река,,	Snohomish_River
холова,,	Kholova_River
оранжевая,лесото,	Orange_River
грейбулл,река,соединённые штаты америки,грейбулл (вайоминг),мититсе (вайоминг)	Greybull_River
литл-маскингум,,	Little_Muskingum_River
рюккерсбах,,	Rückersbach
финн,река,,	River_Finn
штротбах,,	Strothbach
калаус,,	Kalaus_River
мансанарес,река,испания,	Manzanares_(river)
осень,река,,	Osen_River
кубань,река,,	Kuban_River
чаваньга,река,россия,	Chavanga_River
зельц,река,,	Selz
ларами,река,,форт-ларами (вайоминг),ларами (вайоминг),уитленд (вайоминг)	Laramie_River
минчо,,	Mincio
емца,река,,	Yemtsa_River
канейдиан-ривер,соединённые штаты америки,	Canadian_River
парманка,,	Parmanka_River
инглиш-ривер,канада,	English_River_(Ontario)
доммел,,	Dommel
колдью,,	River_Caldew
ухтым,река,,	Ukhtym_River
неошо,соединённые штаты америки,	Neosho_River
шенандоа,река,соединённые штаты америки,front royal, virginia,luray, virginia,harpers ferry, west virginia	Shenandoah_River
сана,река,,	Sana_(river)
тарпенбек,,	Tarpenbek
мойи,река,,	Moyie_River
кейни-форк,соединённые штаты америки,	Caney_Fork_River
енисей,монголия,абакан,дивногорск,дудинка,игарка,кызыл,лесосибирск,саяногорск,шагонар,енисейск,красноярск	Yenisei_River
рио-кончос,,	Rio_Conchos
усвяча,,	Usvyacha_River
буттербах,,	Butterbach
бурея,река,россия,	Bureya_River
колыма,,	Kolyma_River
мечи,индия,	Mechi_River
отта,река,,	Otta_(river)
вычегда,,	Vychegda_River
обербек,,	Oberbek
вепш,польша,	Wieprz
серкьо,,	Serchio
каму,доминиканская республика,консепсион-де-ла-вега	Camú_River
саут-форк-флатхед,,	South_Fork_Flathead_River
вилюй,,	Vilyuy_River
ковик,река,канада,	Kovik_River
рамме,,	Ramme
вайсе-эльстер,,	White_Elster
лорел-форк,,	Laurel_Fork_(Cheat_River)
аброкксбах,,	Abrocksbach
паханг,река,,	Pahang_River
лхаса,река,,	Lhasa_River
куру,река,впадает в атлантический океан,,	Kourou_(river)
инд,китайская народная республика,хайдарабад (город, пакистан),лех (индия)	Indus_River
уилинг-крик,соединённые штаты америки,	Wheeling_Creek_(West_Virginia)
малад,река,соединённые штаты америки,	Malad_River
эльки,река,,	Elqui_River
кагера,бурунди,	Kagera_River
шаларон,,	Chalaronne
стир-крик,соединённые штаты америки,	Steer_Creek_(West_Virginia)
шур,река,типперэри (графство),	River_Suir
андроскоггин,река,,оберн (мэн),берлин (нью-гэмпшир),льюистон (мэн)	Androscoggin_River
егошиха,река,,	Yegoshikha_River
эккбах,,	Eckbach
кагаян,река,филиппины,	Cagayan_River
уаза,река,,	Oise_(river)
глатт,,	Glatt_(Neckar)
ингулец,река,,	Inhulets_River
лёрмекке,,	Lörmecke
большой мендерес,турция,айдын,назилли,сёке	Büyük_Menderes_River
пива,черногория,	Piva_(river)
талкитна,река,,	Talkeetna_River
гартамп,река,,	Gartempe
рубикон,,	Rubicon
туманная,китайская народная республика,	Tumen_River
танагро,,	Tanagro
солис-гранде,,	Solís_Grande_Creek
чаттахучи,река,chattahoochee-oconee national forest,	Chattahoochee_River
риббл,река,,	River_Ribble
азе,,	Ahse
зольмсбах,,	Solmsbach
бесос,,	Besòs_(river)
хенти,река,,	Henty_River
нарев,белоруссия,	Narew
рётельбах,,	Rötelbach_(Jagst)
дамодар,река,индия,бардхаман,асансол,дургапур (западная бенгалия),западная бенгалия	Damodar_River
мацеста,река,россия,сочи	Matsesta_River
зауэрборнсбах,,	Sauerbornsbach
саскуэханна,соединённые штаты америки,бингемтон,гаррисберг,уилкс-барре	Susquehanna_River
борстенбах,,	Borstenbach
педья,река,,	Pedja_(river)
больгенах,,	Bolgenach
вильдебах,,	Wildebach
сучжоухэ,цзянсу,	Suzhou_Creek
свидь,,	Svid_River
маморе,боливия,	Mamoré_River
дармюленбах,,	Darmühlenbach
у,река,,	Ukhta_River
леба,река,,	Łeba_(river)
в,река,румыния,	Vâlsan_River_(Argeș)
самур,азербайджан,samurçay	Samur_River
урс,река,,	Ource
чапора,река,индия,	Chapora_River
бротенау,,	Brotenaubach
миркер-бах,,	Hohenhager_Bach
спаниш-форк,,	Spanish_Fork_River
барку,река,,isisford, queensland,tambo, queensland,blackall, queensland	Barcoo_River
тулома,лапландия (провинция),	Tuloma_River
крузгамепа,сьюард (полуостров),	Kruzgamepa_River
махакам,индонезия,	Mahakam_River
дотнувеле,,	Dotnuvėlė
хениль,испания,	Genil
шельде,,	Schelde_(Dill)
зайендеруд,,	Zayanderud
мотлава,,	Motława
ханфбах,,	Hanfbach
мотагуа,гватемала,	Motagua_River
бауна,,	Bauna
одьель,,	Odiel
амгуэма,река,,	Amguema_River
сиснес,река,,	Cisnes_River
банфе,,	Banfe_(Lahn)
резовска,,	Rezovo_River
сент-круа,река,,	St._Croix_River_(Maine–New_Brunswick)
батар,река,венгрия,	Batar_(river)
граник,,	Biga_Çayı
гера,река,,	Gera_(river)
эмс,германия,эмден,гютерсло,лер (город),варендорф,меппен,папенбург,реда-виденбрюк,райне,линген (эмс)	Ems_(river)
ампер,река,,	Amper
танана,река,,	Tanana_River
черчилл,река,впадает в атлантический океан,,	Churchill_River_(Atlantic)
иннерсте,,	Innerste
сутла,,	Sutla
гайль,,	Gail_(river)
окаванго,река,ангола,	Okavango_River
алена,,	Alène
бэр,река,соединённые штаты америки,	Bear_River_(Utah)
киллик,река,юкон-коюкук,	Killik_River
иравади,река,,банмо,мандалай,мьичина	Irrawaddy_River
лофа,река,,	Lofa_River
уленбах,,	Uhlenbach_(Werre)
андога,,	Andoga_River
чопау,река,,	Zschopau_(river)
обводный канал,,	Obvodny_Canal
гхаггар-хакра,индия,	Ghaggar-Hakra_River
версуа,река,,	Versoix_(river)
вора,река,,	Wohra_(Ohm)
суилли,река,,	River_Swilly
кинабатанган,река,,	Kinabatangan_River
сенна,река,,	Zenne
шеллефтеэльвен,швеция,	Skellefte_River
сабармати,индия,гандинагар,ахмадабад	Sabarmati_River
большой кей,южно-африканская республика,	Great_Kei_River
луэн,река,,	Loing
нердар,,	Neerdar_(Wilde_Aa)
бечва,река,чехия,границе (район пршеров)	Bečva
руме,,	Rhume
большая невка,,	Bolshaya_Nevka_River
трюггельбах,,	Trüggelbach
струмица,река,,	Strumica_(river)
нидэльва,река,впадает в норвежское море,,	Nidelva
хауне,,	Haune
зиттенбах,,	Sittenbach
читарум,,	Citarum_River
утукок,national petroleum reserve–alaska,	Utukok_River
альякмон,,	Haliacmon
хагенбах,река,,	Hagenbach_(river)
д,река,остров мэн,кросби (остров мэн),дуглас (остров мэн)	River_Dhoo
молочная,река,,	Molochna_River
зала,река,,	Zala_(river)
свента,,	Šventoji_(Baltic)
каука,река,,	Cauca_River
жижия,румыния,	Jijia_River_(Prut)
нактонган,республика корея,	Nakdong_River
тарколес,река,,	Tárcoles_River
хамбер,река,великобритания,,	Humber
телес,,	Teles_River
эрф,,	Erf_(river)
персе,река,,	Pērse
б,река,румыния,бухуши,бакэу,пьятра-нямц,ватра-дорней	Bistrița_River_(Siret)
дирилло,,	Dirillo
рега,река,,	Rega
зиндельбах,,	Sindelbach
ханган,корейская народно-демократическая республика,	Han_River_(Korea)
сент-мэрис,река,канада,су-сент-мари (онтарио),су-сент-мари (мичиган)	St._Marys_River_(Michigan–Ontario)
шпрелер-бах,,	Spreeler_Bach
чаупхрая,,	Chao_Phraya_River
шварцер-кохер,,	Schwarzer_Kocher
щ,река,,	Shchuchya_River
сира,река,,	Sira_(river)
колубара,,	Kolubara
саут-саскачеван,канада,	South_Saskatchewan_River
цна,река,впадает в мстино,,	Tsna_River_(Tver_Oblast)
смотрич,река,украина,	Smotrych_River
ворьема,река,норвегия,	Jakobselva_(Sør-Varanger)
иньва,,	Inva_River
янтра,,	Yantra_(river)
каби,уганда,	River_Kafu
провадийска,,	Provadiya_River
туканнон,гарфилд (округ, вашингтон),	Tucannon_River
айб,река,,	Eyb
нюролька,,	Nyurolka_River
ситаун,река,,	Sittaung_River
рей,река,,	Rae_River
умба,река,россия,	Umba_River_(Russia)
недеррейн,,	Nederrijn
хельграбен,,	Hellgraben
кляйне-энц,,	Kleine_Enz
эссе,река,,	Esse_(Diemel)
сена,,	Seine
пиньос,,	Pineios_(Thessaly)
саут-наханни,,	South_Nahanni_River
уильямсон,река,соединённые штаты америки,	Williamson_River_(Oregon)
килль,,	Kyll
пфинц,,	Pfinz
перияр,река,индия,kalady,malayattoor,neriamangalam,aluva	Periyar_(river)
ольмес,,	Olmes
лойкбах,,	Leukbach
уалхондинг,,	Walhonding_River
пис,река,канада,форт-сент-джон	Peace_River
дите,,	Diete
мемеле,,	Nemunėlis
сакраменто,река,соединённые штаты америки,сакраменто (калифорния),дейвис (калифорния),антиок (калифорния),реддинг (калифорния)	Sacramento_River
аттерт,,	Attert_(river)
лаба,,	Laba_River
карманаша,индия,	Karmanasa_River
штайнбеке,,	Steinbeke
особлага,река,,	Osobłoga
зундербах,,	Sunderbach_(Else)
ыхне,,	Õhne
мульде,,	Mulde
царап-лингти-чу,индия,	Tsarap_River
егорлык,,	Yegorlyk_River
фалем,гвинея,	Falémé_River
фельдербах,,	Felderbach
гумбольдт,река,элко (округ, невада),	Humboldt_River
непонсет,река,,	Neponset_River
фиш,река,впадает в берингово море,,	Fish_River_(Alaska)
штедерау,,	Stederau
хофзифен,,	Hofsiefen
лаяри,пакистан,	Lyari_River
цена,река,,	Cena_(river)
анактувук,,	Anaktuvuk_River
оредеж,река,,	Oredezh_River
мидл-форк-флатхед,соединённые штаты америки,	Middle_Fork_Flathead_River
жак-картье,,	Jacques-Cartier_River
хаслохбах,,	Haslochbach
гутнах,,	Gutnach
чаткал,киргизия,	Chatkal_River
экуан,река,канада,	Ekwan_River
кулой,река,впадает в белое море,,	Kuloy_River_(White_Sea)
лайта,река,,	Leitha
тичино,река,,	Ticino_(river)
кунани,река,,	Cunani_River
такуари,река,,	Tacuarí_River
гансбах,,	Gansbach_(river)
шельда,,	Scheldt
юбай,,	Ubaye
места,,	Nestos_(river)
иллинойс,река,,	Illinois_River
наникен,,	Naniken_River
платт,река,колорадо,фримонт (небраска),гранд-айленд (небраска),карни,норт-платт (небраска),омаха	Platte_River
эмшер,,	Emscher
треббия,,	Trebbia
гюнц,,	Günz
шер,река,,	Cher_(river)
шелифф,алжир,	Chelif_River
стрельна,река,впадает в белое море,россия,	Strelna_River
селе,река,впадает в тирренское море,,	Sele_(river)
доссе,река,,	Dosse
лиелупе,,	Lielupe
гавья,,	Gauja_(Neman)
плантэйн-гарден,,	Plantain_Garden_River
нин,река,великобритания,	River_Nene
патаксент,соединённые штаты америки,bowie, maryland,columbia, maryland,laurel, maryland,upper marlboro, maryland	Patuxent_River
шелленбах,,	Schellenbach
гирбах,,	Gierbach
д,река,северная дакота,янктон (южная дакота),митчелл (южная дакота),абердин (южная дакота),гурон (южная дакота)	James_River_(Dakotas)
толка,река,впадает в пролив святого георга,,	River_Tolka
мёрт,,	Meurthe_(river)
форелленбах,,	Forellenbach_(Weser)
арувими,,	Aruwimi_River
торьон,,	Taurion
ллано,река,соединённые штаты америки,	Llano_River
большой иргиз,,	Bolshoy_Irgiz_River
читина,река,,	Chitina_River
исикари,река,япония,	Ishikari_River
асдорф,,	Asdorf
полометь,,	Polomet_River
алабама,река,,	Alabama_River
юнган,швеция,	Ljungan
темерник,,	Temernik_River
гаронна,,	Garonne
махавели,,	Mahaweli_River
варменау,,	Warmenau
селея,,	Seleya_River
блэк-кей,южно-африканская республика,	Black_Kei_River
олт,румыния,сфынту-георге,рымнику-вылча,слатина (румыния)	Olt_River
капша,,	Kapsha_River
гольдерсбах,,	Goldersbach
уругвай,река,аргентина,	Uruguay_River
матануска,река,соединённые штаты америки,	Matanuska_River
бакленд,река,,	Buckland_River
тифина,,	Tifina_River
коацакоалькос,река,мексика,минатитлан (веракрус),матиас-ромеро	Coatzacoalcos_River
эйвон,река,южный остров,,	Avon_River_(Canterbury)
рин,река,,	Rhin
салтен,река,,	Sultan_River
дон,река,впадает в северное море,,	River_Don,_Aberdeenshire
гинсбах,,	Ginsbach_(Jagst)
калль,ручей,	Kall_(Rur)
кукенан,река,,	Cuquenán_River
палена,река,аргентина,	Palena_River
дог-салмон,,	Dog_Salmon_River
верзаска,,	Verzasca_River
хонер-бах,,	Hohner_Bach
гёула,река,впадает в северное море,,	Gaula_(Sogn_og_Fjordane)
косапилья,,	Cosapilla_River
кугарт,,	Kögart_River
александр,река,,	Nahal_Alexander
буна,река,албания,шкодер	Bojana_(river)
низьва,,	Nizva_River
кутеней,река,канада,каслгар,боннерс-ферри (айдахо),либби (монтана)	Kootenay_River
куин,река,тасмания,west coast, tasmania,куинстаун (тасмания)	Queen_River
тринити,река,,	Trinity_River_(Texas)
штрайтмюльбах,,	Streitmühlbach
пьяна,,	Pyana_River
амур,хэнтий,тунцзян (цзямусы)	Amur_River
ауэ,река,,	Aue_(Weser)
бия,,	Biya_River
урик,,	Urik_River
хубертусбах,,	Hubertusbach
уналаклит,река,,	Unalakleet_River
кронах,река,,	Kronach_(Haßlach)
вера,река,,	Wehra
теуантепек,река,,	Tehuantepec_River
большой ашап,,	Bolshoy_Ashap_River
роуб,,	Robe_River_(Ireland)
а,река,,	Ach_(Blau)
брамшебах,,	Bramschebach
мило,река,гвинея,	Milo_River
вольтурно,,	Volturno
тосна,,	Tosna_River
бым,,	Bym_River
сунгача,,	Songacha_River
сиуслоу,река,соединённые штаты америки,	Siuslaw_River
монокаси,карролл (округ, мэриленд),фредерик (мэриленд)	Monocacy_River
нежарка,,	Nežárka
гуадалопе,,	Guadalope
шеффленц,,	Schefflenz_(Jagst)
валлуф,река,,	Walluf_(Rhine)
фауэрбах,,	Fauerbach_(Usa)
чирчик,река,узбекистан,	Chirchiq_River
исеть,,	Iset_River
турунчук,,	Turunchuk_River
путумайо,река,бразилия,	Putumayo_River
об,река,,	Aube_(river)
нафбах,,	Naafbach
правая лесная,,	Leśna_Prawa
уокер-крик,соединённые штаты америки,	Walker_Creek_(West_Virginia)
ридбах,река,,	Riedbach_(Kinzig)
шлина,,	Shlina_River
аранка,тимиш (жудец),	Aranca_River
алакнанда,индия,	Alaknanda_River
нарва,река,эстония,ивангород,нарва,нарва-йыэсуу	Narva_River
ц,река,,	Tsna_River_(Pripyat)
большая кокшага,,	Bolshaya_Kokshaga_River
нирс,,	Niers
гимбах,,	Gimbach
большой зеленчук,,	Bolshoy_Zelenchuk_River
вильде-родах,,	Wilde_Rodach
хёрстерольцер-бах,,	Hörsterholzer_Bach
казари,,	Kasari_(river)
зесмарбах,,	Seßmarbach
ваннигсбах,,	Wannigsbach
бандон,,	River_Bandon
лулонга,,	Lulonga_River
куршаб,река,киргизия,	Kurshab_River
лямин,река,,	Lyamin_River
джубба,,	Jubba_River
акри,река,боливия,	Acre_River
беннир-грабен,,	Bennier_Graben
малый енисей,монголия,	Little_Yenisei_River
ремлинградер-бах,,	Remlingrader_Bach
монноу,англия,	River_Monnow
раздан,река,,	Hrazdan_River
дармбах,,	Darmbach
мерчисон,река,,	Murchison_River_(Western_Australia)
айвиексте,,	Aiviekste
хей,река,,	Hay_River_(Canada)
варзуга,река,,	Varzuga_River
соча,,	Soča
флиндерс,река,австралия,	Flinders_River
эггель,,	Eggel
вайккойоки,финляндия,	Vaikkojoki
грюмпель,,	Grümpel
да,река,,	Black_River_(Asia)
сантерно,река,,	Santerno
спокан,река,соединённые штаты америки,	Spokane_River
сан-хуан,река,впадает в ла-плату,,	San_Juan_River_(Uruguay)
шнаудер,,	Schnauder
уэби-шабелле,,	Shebelle_River
тигарт-крик,соединённые штаты америки,	Tygart_Creek
р,река,,	Röllbach_(Usa)
струма,река,,	Struma_(river)
шахе,,	Shakhe_River
майзингер-бах,,	Maisinger_Bach
асбеке,,	Asbeke
аламо,река,нижняя калифорния,	Alamo_River
муд,река,,	Mud_(river)
иртыш,,	Irtysh_River
лемпа,река,сальвадор,	Lempa_River
кальмиус,,	Kalmius
вебер,река,,	Weber_River
реген,река,,	Regen_(river)
мадон,река,,	Madon
кубня,,	Kubnya_River
увез,,	Ouvèze
суон,река,,	Swan_River_(Western_Australia)
омербах,,	Omerbach
галлатин,,	Gallatin_River
томпсон,река,канада,	Thompson_River
хохшпайербах,,	Hochspeyerbach
митбах,,	Mitbach
кишон,река,израиль,хайфа	Kishon_River
поной,россия,	Ponoy_River
молалла,соединённые штаты америки,	Molalla_River
детройт,река,канада,уинсор (онтарио)	Detroit_River
миссисипи,соединённые штаты америки,миннеаполис,батон-руж,ла-кросс (висконсин),четыре города,сент-луис,мемфис (теннесси),новый орлеан,сент-пол (миннесота)	Mississippi_River
завхан,река,монголия,	Zavkhan_River
лойнсбах,,	Läunsbach
саду,река,,	Sado_River
валдайка,,	Valdayka_River
паудер,соединённые штаты америки,	Powder_River_(Wyoming_and_Montana)
шуртан,,	Shurtan_River
оникс,река,,	Onyx_River
ягст,,	Jagst
рог,река,впадает в тихий океан,,грантс-пасс	Rogue_River_(Oregon)
вольф,река,,	Wolf_(river)
хумме,,	Humme_(Weser)
ясачная,,	Yasachnaya_River
бюлер,река,,	Bühler_(river)
ноттавей,канада,	Nottaway_River
дурбеке,,	Durbeke
тиете,река,бразилия,	Tietê_River
вёрсбах,,	Wörsbach_(Emsbach)
гломма,норвегия,	Glomma
вяйке-эмайыги,,	Väike_Emajõgi
кухва,,	Kukhva_River
сазава,чехия,	Sázava_(river)
алазани,,	Alazani
качава,,	Kaczawa
тур,река,,	Thur_(Switzerland)
лайербах,,	Leyerbach
найобрэра,река,,	Niobrara_River
эвротас,,	Eurotas_(river)
турама,папуа — новая гвинея,	Turama_River
лообу,река,,	Loobu_(river)
астара,река,азербайджан,	Astarachay
у,река,украина,коростень	Uzh_River_(Prypiat)
дрозедовер-бек,,	Drosedower_Bek
кара,река,,	Kara_River
корриб,,	River_Corrib
дюнн,,	Dhünn
альбаумер-бах,,	Albaumer_Bach
у,река,полк (округ, арканзас),хот-спрингс (арканзас)	Ouachita_River
невольничья,,	Slave_River
адзьва,река,,	Adzva_River
каниаписко,река,канада,	Caniapiscau_River
салмон-фолс-крик,соединённые штаты америки,	Salmon_Falls_Creek
пскова,,	Pskova_River
тайн,нортамберленд,	River_Tyne
ныса-лужицка,чехия,	Lusatian_Neisse
эллерброкграбен,,	Ellerbrockgraben
абах,,	Aabach_(Afte)
ульфа,река,,	Ulfa_(river)
кетл,река,канада,гранд-форкс (британская колумбия)	Kettle_River_(Columbia_River)
агонья,,	Agogna
ансэба,река,,	Anseba_River
вадрилль,,	Wadrill_(Prims)
канагёл,румыния,	Canora_River
х,река,соединённые штаты америки,	Gila_River
когинас,,	Coghinas
лимай,,	Limay_River
раму,река,папуа — новая гвинея,	Ramu
сола,река,,	Soła
дора-рипария,,	Dora_Riparia
урал,река,,	Ural_River
ангара,,	Angara_River
свратка,,	Svratka_(river)
пастаса,река,эквадор,	Pastaza_River
джамна,индия,агра,аллахабад,дели,этавах,калпи,матхура,ямунанагар	Yamuna
темписке,коста-рика,palo verde biological station	Tempisque_River
пегниц,река,,	Pegnitz_(river)
айтерах,,	Aiterach
окмалги,река,,	Ocmulgee_River
т,река,соединённые штаты америки,	Trinity_River_(California)
б,река,румыния,	Bogonos_River
вершбах,,	Werschbach
смилга,река,,	Smilga_River
т,река,россия,кемерово,новокузнецк,северск,юрга,томск,междуреченск (значения)	Tom_River
ледь,,	Led_River
тонг,река,,	Tongue_River_(Montana)
курмакаш,,	Kurmakash_River
гумаль,,	Gomal_River
миява,река,чехия,	Myjava_(river)
лизе,,	Liese_(river)
ульвич,,	Ulvich_River
гозенбах,,	Gosenbach
услава,,	Úslava
мали,река,,	Mali_River
иецава,река,,	Iecava_(river)
сагаваниркток,,	Sagavanirktok_River
текланика,,	Teklanika_River
напо,река,эквадор,	Napo_River
бике,,	Bieke_(Bigge)
большая вая,,	Bolshaya_Vaya_River
фалькенбах,река,,	Falkenbach_(Omersbach)
ф,река,,	Friesenbach_(Roter_Main)
мононгахила,,	Monongahela_River
низе,,	Niese_(Emmer)
лех,река,,	Lech_(river)
купфер,река,,	Kupfer_(river)
дода,река,индия,	Doda_River
чёрная турка,,	Chyornaya_Turka_River
маулах,,	Maulach
талас,река,казахстан,	Talas_River
санкара,река,,	Záncara
гуадалупе,река,впадает в мексиканский залив,соединённые штаты америки,	Guadalupe_River_(Texas)
альзенц,река,,	Alsenz_(river)
рутебах,,	Ruthebach
бентграбен,,	Bentgraben
брианса,,	Briance
гарильяно,,	Garigliano
онега,река,,	Onega_River
рузвельт,река,бразилия,	Roosevelt_River
дон,россия,	Don_River_(Russia)
лайсбах,,	Laisbach
калле,,	Kalle_(river)
вах,река,,	Vakh_River
бекстер,,	Bexter
ф,река,германия,	Vils_(Danube)
крынка,река,,	Krynka_River
этран,река,вестергётланд,	Ätran_(river)
южная аньва,,	Yuzhnaya_Anva_River
маас,,льеж,маастрихт,венло (община),шарлевиль-мезьер,намюр (значения),седан (город)	Meuse_(river)
словечна,река,,	Slovechna
швиппе,,	Schwippe
унтере-штайнах,,	Untere_Steinach
с,река,индия,	Suru_River_(Indus)
сучава,река,румыния,сучава	Suceava_River
кальтес-вассер,,	Kaltes_Wasser
ильпе,,	Ilpe
шеде,,	Schede_(river)
тускарь,,	Tuskar_River
тайснах,река,,	Teisnach_(river)
доспат,река,,	Dospat_(river)
хайпкер-бах,,	Heipker_Bach
флинт,река,,	Flint_River_(Georgia)
нид,река,,	Nied
ахья,,	Ahja_(river)
лойкзенбах,,	Leuchsenbach
улуа,гондурас,	Ulúa_River
кюнзебеккер-бах,,	Künsebecker_Bach
йёлленбеккер-мюленбах,,	Jöllenbecker_Mühlenbach
кёц,река,,	Kötz_(Günz)
наб,,	Naab
кефисс,аттика,,	Cephissus_(Athenian_plain)
брисбен,река,,брисбен	Brisbane_River
генкель,река,,	Genkel
парана,аргентина,	Paraná_River
бардуэльва,,	Barduelva
йеллоустон,река,соединённые штаты америки,	Yellowstone_River
фогельталь-бах,,	Vogelthal-Bach
берч-крик,,	Birch_Creek_(Alaska)
илеть,,	Ilet_River
кабул,река,,	Kabul_River
гедиз,,	Gediz_River
пыж,река,,	Pyzh_River
вутах,река,,	Wutach_(river)
коннектикут,река,соединённые штаты америки,хартфорд (коннектикут),спрингфилд (массачусетс)	Connecticut_River
пярну,река,,	Pärnu_(river)
ниме,,	Nieme
вемерхорстер-бах,,	Wehmerhorster_Bach
сагеней,река,канада,сагеней (город)	Saguenay_River
эльте,,	Elte_(river)
норт-саскачеван,альберта,эдмонтон,принс-альберт (саскачеван)	North_Saskatchewan_River
нявежис,,	Nevėžis_(river)
везуза,,	Vezouze
иллер,,	Iller
эдо,река,,	Edo_River
абукума,япония,корияма,дате (фукусима),фукусима (город),иванума,какуда,мотомия,нихоммацу,сиракава (фукусима),сукагава	Abukuma_River
тате,,	Tati_River
хокинг,река,,	Hocking_River
сенио,,	Senio
свакоп,намибия,	Swakop_River
клайне-хенне,,	Kleine_Henne
арон,река,,	Aron_(Loire)
сенегал,река,мали,	Senegal_River
луар,,	Loir
зея,река,россия,	Zeya_River
колвица,река,россия,	Kolvitsa_River
зенгбах,,	Sengbach
руайа,река,,	Roya_(river)
коюк,река,сьюард (полуостров),	Koyuk_River
акстбах,,	Axtbach
хемельтер-бах,,	Hemelter_Bach
макаль,,	Macal_River
анненбах,,	Annenbach
чинаб,индия,	Chenab_River
линсфербах,,	Linspherbach
мун,река,таиланд,	Mun_River
рымник,румыния,рымнику-сэрат	Râmnicul_Sărat_River
малый ашап,река,,	Maly_Ashap_River
маррамбиджи,австралия,канберра,уогга-уогга	Murrumbidgee_River
чавон,,	Chavón_River
неб,остров мэн,пил (остров мэн)	River_Neb
псёл,,	Psel_River
птичь,,	Ptsich
шнайттах,река,,	Schnaittach_(Pegnitz)
чилкат,река,,	Chilkat_River
висконсин,река,,	Wisconsin_River
питеэльвен,швеция,	Pite_River
ассинибойн,река,канада,	Assiniboine_River
фени,река,бангладеш,	Feni_River
мандови,индия,	Mandovi_River
пульинке,река,,	Pullinque_River
фиагдон,,	Fiagdon_River
сан-мигель,река,,	San_Miguel_River_(Colorado)
кламат,река,,klamath falls, oregon	Klamath_River
индравати,,	Indravati_River,_Nepal
большая лямпа,,	Bolshaya_Lyampa
ослава,река,,	Oslava
бёрстельбах,,	Börstelbach
прово,река,соединённые штаты америки,	Provo_River
рось,,	Ros_River
медуэй,река,западный суссекс,	River_Medway
неман,,	Neman_(river)
лёнер-шульбах,,	Löhner_Schulbach
лух,река,россия,	Lukh_River
ридер-бах,,	Rieder_Bach_(Mindel)
гатино,река,,	Gatineau_River
чурал,,	Chural_River
жошуй,китайская народная республика,	Ruo_Shui
вискан,швеция,	Viskan
вишеу,румыния,борша (румыния),вишеу-де-сус	Vișeu_River
авизио,,	Avisio
пойма,река,,	Poyma_River
рейвенсборн,англия,дептфорд	River_Ravensbourne
ахурян,,	Akhurian_River
аньене,,	Aniene
люттер,,	Lütter
штайнаггер,,	Steinagger
ямпа,,craig, colorado,steamboat springs, colorado	Yampa_River
юрмыс,,	Yurmys_River
цильма,,	Tsilma_River
шемкир,кедабекский район,	Shamkirchay
атбара,река,,	Atbarah_River
солис-чико,,	Solís_Chico_Creek
хорбахер-бах,,	Horbacher_Bach
био-био,река,,	Bío_Bío_River
гурк,река,,	Gurk_(river)
фергус,река,,	River_Fergus
файбах,,	Veybach
ла-плата,эстуарий,уругвай (река)	Río_de_la_Plata
вибах,,	Wiebach
илимпея,,	Ilimpeya_River
альта,река,,	Alta_River
аниакчак,река,,	Aniakchak_River
усьва,,	Usva_River
кодыма,река,,	Kodyma_River
зекках,река,,	Seckach_(Jagst)
умеэльвен,швеция,	Ume_River
норт-форк-флатхед,канада,	North_Fork_Flathead_River
хантер,река,австралия,мейтленд (новый южный уэльс),ньюкасл (австралия)	Hunter_River_(New_South_Wales)
сестра,река,впадает в сестрорецкий разлив,,	Sestra_River_(Leningrad_Oblast)
гандловка,,	Handlovka
седедема,,	Sededema_River
ренгзе,,	Rengse
хьюон,река,,хьюонвилл (тасмания)	Huon_River
в,река,,	Vyoksa_River
царнов,,	Zarnow_(river)
торренс,река,,	River_Torrens
сып,,	Syp_River
сурис,река,канада,майнот (северная дакота)	Souris_River
нете,,	Nethe
гайсбах,,	Geisbach
тэнрю,река,,	Tenryū_River
барте,,	Barthe_(river)
ёдо,,	Yodo_River
жапура,бразилия,	Japurá_River
ориноко,колумбия,	Orinoco
круммбах,,	Krummbach_(Ablach)
ауде-маас,,	Oude_Maas
аурайоки,река,впадает в балтийское море,,	Aura_(Archipelago_Sea)
шальчя,,	Šalčia
нурец,река,,	Nurzec
клен,река,,	Clain
глоттер,,	Glotter
чакачатна,река,,	Chakachatna_River
теберда,река,,	Teberda_River
слэни,река,,	River_Slaney
сноуи-ривер,австралия,jindabyne, new south wales,marlo, victoria,orbost	Snowy_River
редниц,,	Rednitz
атерно-пескара,,	Aterno-Pescara
сухотыль,,	Sukhotyl_River
лулеэльвен,норвегия,	Lule_River
метуе,,	Metuje
лувуа,река,,	Luvua_River
синка,река,,	Cinca_(Spain)
аргун,река,,	Argun_River_(Caucasus)
азат,река,армения,	Azat_River
форхбах,,	Forchbach
илеша,,	Ilesha_River
касилоф,,	Kasilof_River
индальсэльвен,швеция,	Indalsälven
мулуя,,	Moulouya_River
виктория,река,впадает в тиморское море,австралия,	Victoria_River_(Northern_Territory)
випава,,	Vipava_(river)
фрайбергер-мульде,,	Freiberger_Mulde
сабин,река,впадает в мексиканский залив,соединённые штаты америки,	Sabine_River_(Texas–Louisiana)
детина,,	Đetinja
фреттербах,,	Fretterbach
дазе,,	Dase_(Erpe)
аракс,,	Aras_(river)
мухавец,,	Mukhavets_River
памбак,,	Pambak_River
пит,река,,	Pit_River
а,река,германия,	Ahr
вардар,,	Vardar
лоцане,ботсвана,	Lotsane_River
найфер-бах,,	Naifer_Bach
чикаския,река,соединённые штаты америки,	Chikaskia_River
вёрниц,река,,	Wörnitz_(river)
палус,река,,	Palouse_River
хабигхорстер-бах,,	Habighorster_Bach
вымь,,	Vym_River
глиндер-ау,,	Glinder_Au
раннах,,	Rannach
сакарья,река,,	Sakarya_River
тенниёйоки,финляндия,	Tenniöjoki
танншорренбах,,	Tannschorrenbach
ливенка,река,россия,	Livenka_River
луара,ардеш,	Loire
випперфельдер-бах,,	Wipperfelder_Bach
кызылырмак,турция,	Kızılırmak_River
клайд,река,шотландия,	River_Clyde
арсеньевка,,	Arsenyevka_River
ос,река,,	Oos_(river)
тердоппио,,	Terdoppio
камберленд,река,кентукки,нашвилл,кларксвилл (теннесси)	Cumberland_River
тунтсайоки,финляндия,	Tuntsayoki
пандо,река,,	Pando_Creek
воркута,река,,	Vorkuta_River
дром,река,,	Drôme_(river)
грюндау,река,,	Gründau_(river)
нигер,река,бенин,	Niger_River
санта-круз,река,,	Santa_Cruz_River_(Arizona)
молонгло,река,австралия,куинбиан	Molonglo_River
кюмийоки,,	Kymi_(river)
татшеншини,,	Tatshenshini_River
лумбовка,река,россия,	Lumbovka_River
бивер,река,канада,	Beaver_River_(Canada)
оскуя,,	Oskuya_River
меконг,камбоджа,	Mekong
фальбах,река,,	Fallbach_(Kinzig)
тана,река,впадает в формозу,,	Tana_River_(Kenya)
гав-де-по,,	Gave_de_Pau
носка,,	Noska
араде,португалия,	Arade_River
кондома,россия,калтан,осинники,таштагол	Kondoma_River
дзорагет,,	Dzoraget_River
ш,река,,	Steinbach_(Nidda)
обша,,	Obsha_River
селижаровка,россия,	Selizharovka_River
оунасйоки,,	Ounasjoki
маникуаган,река,канада,	Manicouagan_River
амгунь,россия,	Amgun_River
диттайно,,	Dittaino
меммингер-ах,,	Memminger_Aach
айтрах,река,,	Aitrach_(Iller)
муррей,река,,олбери,милдьюра,суон-хилл,марри-бридж,уодонга	Murray_River
ханьшуй,шэньси,	Han_River_(Shaanxi_and_Hubei)
пеннар,река,индия,неллуру	Penna_River
ярра,река,,мельбурн	Yarra_River
окер,,	Oker
крехенбах,,	Krähenbach_(Kammel)
ш,река,соединённые штаты америки,	Shasta_River
рётен,река,,	Röthen
тугела,южно-африканская республика,colenso, kwazulu–natal	Tugela_River
фортимайл,,	Fortymile_River
дайман,,	Daymán_River
факатане,река,,	Whakatane_River
гленне,,	Glenne_(Möhne)
тине,,	Tinée
симуа,,	Simoa
плайхах,,	Pleichach
рувер,река,,	Ruwer_(river)
эрмс,,	Erms
рена,река,,	Rhena_(Neerdar)
молодо,,	Molodo_River
пинега,река,,	Pinega_River
хортон,река,канада,	Horton_River_(Canada)
альц,,	Alz
уаикато,река,,	Waikato_River
глейди-форк,соединённые штаты америки,	Glady_Fork
ципфельбах,,	Zipfelbach_(Neckar)
шатт-эль-араб,иран,	Shatt_al-Arab
хараа-гол,монголия,	Kharaa_River
бемпинг,соединённые штаты америки,	Bumping_River
эндр,река,,	Indre_(river)
штевер,,	Stever
кайнсбах,,	Kainsbach
драйзам,германия,	Dreisam
хиртенбах,,	Hirtenbach_(Wetter)
боу,река,,	Bow_River
сан-хуан,река,впадает в тихий океан,,	San_Juan_River_(Colombia)
ибс,,	Ybbs
дие,,	Thaya
халлисте,река,,	Halliste_(river)
перибонка,река,,	Peribonka_River
бребах,,	Brebach_(Spreeler_Bach)
нуне,,	Nuhne
ше,река,,	Chée
баиз,,	Baïse
штендлиц,,	Stendlitz
эсгева,бургос (провинция),	Esgueva
книстербах,,	Knisterbach
саут-платт,река,,	South_Platte_River
педерналес,река,соединённые штаты америки,	Pedernales_River
шварцвассербах,,	Schwarzwasserbach_(Ems)
вайдбах,германия,	Stege_and_Waidbach
чукля,,	Chuklya_River
аллагаш,соединённые штаты америки,	Allagash_River
ватсиманйоки,россия,	Vatsimanyoki_River
бени,река,боливия,	Beni_River
альбек,река,,	Aalbek_(Hemmelsdorfer_See)
зальц,,	Salz_(river)
эль-аси,ливан,хама,хомс,антакья,джиср-эш-шугур	Orontes_River
сох,река,киргизия,	Sokh_River
юна,река,впадает в залив самана,доминиканская республика,bonao,cotuí	Yuna_River
шуя,река,впадает в логмозеро,,	Shuya_River_(Karelia)
кнёзельбах,,	Knöselbach
хольтебах,,	Holtebach
кавери,индия,	Kaveri
малше,,	Malše
ы,река,,	Y_River
л,река,соединённые штаты америки,	Lewis_River_(Washington)
касадепага,,	Casadepaga_River
т,река,англия,	River_Teme
анабар,,	Anabar_River
штайнзикбах,,	Steinsiekbach
эльзава,,	Elsava
джамейка,бухта,соединённые штаты америки	Jamaica_Bay
сэнд-форк,соединённые штаты америки,	Sand_Fork_(Little_Kanawha_River)
камак,,	River_Camac
мильц,река,,	Milz_(river)
с,река,канада,	Stuart_River
мантаро,перу,	Mantaro_River
тальяменто,,	Tagliamento
мистель,,	Mistel_(Red_Main)
кура,река,отвод,малки,россия,	Kura_River_(Russia)
турнеэльвен,финляндия,	Torne_(river)
инде,,	Inde
лепсы,река,,	Lepsy_River
опон,,	Opon_River
сан-антонио,река,,	San_Antonio_River
палар,,	Palar_River
аппоматтокс,река,соединённые штаты америки,питерсберг (виргиния)	Appomattox_River
зенбах,,	Seenbach
набесна,река,рангел — сент-элайас,	Nabesna_River
эйвон,река,впадает в бристольский залив,,бат (англия),бристоль,брэдфорд-на-эйвоне	River_Avon_(Bristol)
хаймбах,река,,	Heimbach_(Glatt)
бруно,река,элко (округ, невада),	Bruneau_River
хунгербах,,	Hungerbach_(Gennach)
гильза,река,,	Gilsa_(Schwalm)
маркбах,,	Markbach_(Else)
хесбах,река,,	Heesbach
полочик,,	Polochic_River
пурари,река,папуа — новая гвинея,	Purari_River
н,река,ватога (округ, северная каролина),	New_River_(Kanawha_River)
тамур,река,,	Tamur_River
ш,река,германия,	Schwarza_(Black_Forest)
ненана,река,соединённые штаты америки,	Nenana_River
малая кокшага,,	Malaya_Kokshaga_River
драговиштица,река,,	Dragovištica
зонтра,река,,	Sontra_(river)
ибар,,	Ibar_(river)
энко,,	Enco_River
контровод,,	Kontrovod_River
ниссан,река,швеция,	Nissan_(river)
лиллах,,	Lillach
аделейд,река,австралия,adelaide river, northern territory	Adelaide_River
тарн,река,франция,	Tarn_(river)
крайхбах,,	Kraichbach
франценбах,,	Franzenbach
фуй,река,,	Fui_River
шайх,,	Schaich
вена,река,,	Wien_(river)
грубебах,,	Grubebach
сатледж,индия,	Sutlej
рапель,,	Rapel_River
везюби,,	Vésubie
джеди,,	Djedi_River
молсэльва,,	Målselva
й,река,,	Jossa_(Fulda)
вуппер,,	Wupper
клинч,река,,	Clinch_River
темза,,саутенд-он-си,абингдон (англия),дартфорд,мейденхед,виндзор,марлоу (бакингемшир),грейвзенд,рединг (англия)	River_Thames
большая медвежья,канада,	Great_Bear_River
котра,,	Kotra_(river)
заманты,,	Zamantı_River
сож,река,,	Sozh_River
мохаве,река,соединённые штаты америки,барстоу (калифорния),викторвилл (калифорния)	Mojave_River
вюрцбах,,	Würzbach
алькантара,река,,	Alcantara_(river)
энденихер-бах,,	Endenicher_Bach
эльба,река,чехия,куксхафен,пардубице,штаде,виттенберг,усти-над-лабем,дессау,дрезден,гамбург,магдебург,майсен	Elbe
риполь,река,испания,	Ripoll_(river)
трене,река,,	Treene_(river)
сим,река,,	Sim_River
дуэро,португалия,	Douro
штайнхаузер-бах,,	Steinhauser_Bach_(Wupper)
арьеш,румыния,кымпия-турзи,турда	Arieș_River_(Mureș)
тес-хем,монголия,	Tes_River
мзымта,,	Mzymta_River
наутсийоки,россия,	Nautsiyoki_River
тавиньяно,,	Tavignano
дюзедиксбах,,	Düsedieksbach
истмейн,река,,	Eastmain_River
лиффи,,	River_Liffey
алгети,,	Algeti_River
грейт-фиш,южно-африканская республика,	Great_Fish_River
ауде-маасье,,	Oude_Maasje
фюльбах,,	Füllbach
дайамантина,,	Diamantina_River
мозель,,	Moselle
лань,река,,	Lan_River
кускокуим,юкон-коюкук,	Kuskokwim_River
стугна,река,,	Stuhna_River
кок,река,таиланд,чианграй	Kok_River
чу,река,казахстан,	Chu_River
эск,,	River_Esk,_Cumbria
с,река,россия,	Sukhaya_River
нетфе,,	Netphe
даутфе,,	Dautphe
эммер,река,,	Emmer_(Weser)
свина,,	Świna
а,река,китайская народная республика,	Aksu_River_(Xinjiang)
ранс,река,,	Rance_(river)
нойенхагенер-мюленфлис,,	Neuenhagener_Mühlenfließ
эшерсбах,,	Äschersbach
босут,,	Bosut_(river)
ауса,,	Ausa_(river)
марош,,	Mureș_River
аурах,река,,	Aurach_(Rednitz)
одеборн,,	Odeborn
зиг,,	Sieg
юнгфернбах,,	Jungfernbach_(Kassel)
огайо,река,соединённые штаты америки,питтсбург,эвансвилл,хантингтон (западная виргиния),луисвилл,мэдисон (индиана),уилинг (западная виргиния),цинциннати	Ohio_River
хеккергрундбах,,	Häckergrundbach
углава,,	Úhlava
рави,река,,	Ravi_River
куйсеб,,	Kuiseb_River
пинг,река,,чиангмай	Ping_River
сан-педро,река,аризона,мексика,	San_Pedro_River_(Arizona)
кришна,река,индия,	Krishna_River
ньиве-маас,,	Nieuwe_Maas
кадалунди,индия,	Kadalundi_River
вешниц,,	Weschnitz
файшеде,,	Veischede
блайхенбах,,	Bleichenbach_(Nidder)
гулкана,река,,	Gulkana_River
хамель,река,,	Hamel_(river)
кларэльвен,норвегия,	Klarälven
куштанка,,	Kushtanka_River
тверца,,	Tvertsa_River
квиса,польша,	Kwisa
нушагак,,	Nushagak_River
шондра,река,,	Schondra_(river)
гуаитара,,	Guáitara_River
эгийн-гол,монголия,	Eg_River
самора,река,,	Zamora_River
глемс,,	Glems
омоно,,	Omono_River
дицхёльце,,	Dietzhölze
ипиранга,река,,	Ipiranga_Brook
сороть,,	Sorot_River
я,река,,	Jablanica_(river)
мюрц,,	Mürz
шаннон,река,ирландия,атлон (город),лимерик (город)	River_Shannon
саар,река,,	Saar_(river)
кострома,река,,	Kostroma_River
эллис,река,,	Ellice_River
ерез,река,,	Jerez_(river)
яломица,река,румыния,слобозия (яломица),тырговиште (румыния)	Ialomița_River
селавик,река,,	Selawik_River
тоне,река,,	Tone_River
гвадалквивир,испания,кордова (город, испания)	Guadalquivir
маульин,река,,	Maullín_River
аффингер-бах,,	Affinger_Bach
хайлигенлоэр-беке,,	Heiligenloher_Beeke
лайнлайтер,,	Leinleiter
нордзе-канал,,	North_Sea_Canal
альзет,,	Alzette
ла-плата,река,,	La_Plata_River_(San_Juan_River)
лоббах,река,,	Lobbach_(Elsenz)
мусбах,,	Mußbach
вильц,река,,	Wiltz_(river)
кичуй,,	Kichuy_River
елымовка,,	Yelymovka_River
сус,река,,	Sous_River
ок-теди,река,индонезия,	Ok_Tedi_River
добер,,	Dober_(Kremnitz)
гёттельбах,,	Göttelbach
миляцка,,	Miljacka
реут,,	Răut_River
нельсон,река,,	Nelson_River
кодори,,	Kodori_River
миса,река,,	Misa_(river_in_Latvia)
рио-пас,,	Paz_River
малая миссури,соединённые штаты америки,	Little_Missouri_River_(North_Dakota)
канова,река,соединённые штаты америки,	Kanawha_River
сомеш,,	Someș_River
брент,река,большой лондон,brent cross,greenford,hanwell	River_Brent
тронто,,	Tronto
вайсер-кохер,,	Weißer_Kocher
бормида,река,,	Bormida_(river)
праньди,река,,	Prandi_(river)
вента,,	Venta_(river)
лемп,,	Lemp_(Dill)
юрюзань,река,,	Yuryuzan_River
лоа,река,,	Loa_River
штрангбах,,	Strangbach
блэк-форк,соединённые штаты америки,	Black_Fork_(Cheat_River)
дженеси,река,соединённые штаты америки,рочестер (нью-йорк)	Genesee_River
абава,,	Abava
вар,река,,	Var_(river)
вердура,,	Verdura
мэрэб,,	Mareb_River
тунджа,,	Tundzha
дайльбах,,	Deilbach
берсте,,	Berste
сако,река,,	Saco_River
базенто,,	Basento
латроп,,	Latrop_(Lenne)
хольцкапе,,	Holzkape
омброне,река,,	Ombrone
сухона,,	Sukhona_River
афте,,	Afte
кришул-негру,венгрия,шаркад	Crișul_Negru_River
турыш,река,,	Turysh_River
базавлук,,	Bazavluk_River
чамбал,индия,	Chambal_River
купер-крик,,	Cooper_Creek
бигге,,	Bigge_(river)
лайбах,река,,	Laibach_(Ruthenbach)
алье,река,,	Allier_(river)
салгир,,	Salhir_River
тэкэзе,,	Tekezé_River
цаме-гера,,	Zahme_Gera
шварце-эльстер,,	Black_Elster
корожечна,,	Korozhechna_River
теймар,река,великобритания,англия,	River_Tamar
саха,река,испания,	Saja_(river)
амстел,нидерланды,	Amstel
лепенац,,	Lepenac
ящера,река,,	Yashchera_River
грихальва,,	Grijalva_River
оккервиль,,	Okkervil_River_(Neva_basin)
замина,австрия,	Samina_(river)
рио-буэно,река,,	Bueno_River
чикман,река,,	Chikman_River
зхоб,река,пакистан,	Zhob_River
лихте,река,,	Lichte_(river)
д,река,,	Dubna_(Daugava)
роста,река,россия,	Rosta_River
кацбах,ручей,	Katzbach_(Kraichbach)
коси,река,китайская народная республика,катихар,пурния	Koshi_River
кесбах,,	Käsbach
утьва,,	Utva_River_(Perm_Krai)
симето,река,,	Simeto
ардон,река,,	Ardon_River
егричка,,	Jegrička
черёха,река,,	Cheryokha_River
эсла,,	Esla_(river)
изар,,	Isar
антрефф,,	Antrift
вахш,,	Vakhsh_River
перф,,	Perf_(Lahn)
чира,,	Chira_River
чаньва,,	Chanva_River
френкише-рецат,,	Fränkische_Rezat
шоргаст,,	Schorgast
аллегейни,река,,	Allegheny_River
поддл,,	River_Poddle
пасьон,гватемала,	Pasión_River
виледь,,	Viled_River
линклойер-бах,,	Linkläuer_Bach
хуанхэ,китайская народная республика,	Yellow_River
сюньцзян,,	Xun_River
анапо,,	Anapo
юшут,,	Yushut_River
моркока,,	Morkoka_River
кавалли,река,,	Cavalla_River
гайандотт,соединённые штаты америки,	Guyandotte_River
иккер,,	Uecker
маскингум,,	Muskingum_River
френч-брод,северная каролина,	French_Broad_River
эзино,,	Esino
риу-авиа,,	Avia_(river)
амга,,	Amga_River
плайсбах,,	Pleisbach
лугань,,	Luhan_River
харьяпеа,река,,	Härjapea
блэкуотер,река,ирландия,,	Munster_Blackwater
багмати,непал,лалитпур (непал),катманду	Bagmati_River
вимбекке,,	Wiembecke
зорпе,,	Sorpe_(Röhr)
шойербах,,	Scheuerbach
семлики,уганда,	Semliki_River
лопер-бах,,	Loper_Bach
крапина,река,,	Krapina_(river)
аринос,бразилия,	Arinos_River
лоттенбах,,	Lottenbach
премих,,	Premich
варзина,россия,	Varzina_River
агуан,,	Aguán_River
бусэин-гол,монголия,	Büsein_River
виндбах,,	Windbach
толшма,,	Tolshma_River
клайне-фильс,,	Kleine_Vils
вонгода,,	Vongoda_River
шлюхт,,	Schlücht
эга,река,,	Ega_(river)
диттенбах,,	Dittenbach
офанто,,	Ofanto
мста,,	Msta_River
виндах,река,,	Windach_(river)
орхон,монголия,	Orkhon_River
зингольд,,	Singold
ручь,,	Ruch_River
эмайыги,эстония,	Emajõgi
виннипег,река,,	Winnipeg_River
ауде-рейн,,	Oude_Rijn_(Utrecht_and_South_Holland)
ямжач,,	Yamzhach_River
апуре,река,,	Apure_River
кельбербах,,	Kälberbach_(Seemenbach)
аггер,река,,	Agger_(river)
азельбах,,	Aselbach
сучьяте,река,,	Suchiate_River
экстер,река,,	Exter_(Weser)
кентукки,река,,	Kentucky_River
клайнер-козербах,,	Kleiner_Koserbach
парагвай,река,аргентина,	Paraguay_River
алтаэльв,норвегия,alta (town)	Altaelva
зальбах,,	Saalbach_(Gelpe)
кнохенбах,,	Berlebecke
неретва,,	Neretva
волонь,река,,	Vologne
црна,,	Crna_(river)
тараво,,	Taravo
сирет,румыния,роман (румыния),бакэу,галац,пашкани	Siret_River
эльде,,	Elde
тей,река,северо-шотландское нагорье,	River_Tay
сарта,река,,	Sarthe_(river)
арьеж,река,,	Ariège_(river)
идэр,монголия,	Ider_River
малый мендерес,,	Küçükmenderes_River
бубр,чехия,	Bóbr
белый дрин,,	White_Drin
хайльсбах,,	Heilsbach
памба,река,,	Pamba_River
арапей-гранде,,	Arapey_Grande_River
гирскоппбах,,	Gierskoppbach
угашик,река,,	Ugashik_River
ботан,река,,	Botan_River
ашбертон,река,впадает в индийский океан,,	Ashburton_River_(Western_Australia)
навести,,	Navesti_(river)
кодина,река,,	Kodina_River
супой,,	Supiy_River
плюсса,река,,	Plyussa_River
вога,португалия,	Vouga_River
визяха,,	Vizyakha_River
ноатак,река,юкон-коюкук,	Noatak_River
силь,река,испания,понферрада	Sil_(river)
мелеча,река,,	Melecha_River
восточный дарт,англия,	East_Dart_River
бырзава,румыния,решица	Bârzava_River_(Timiș)
ресава,,	Resava_(river)
муса,река,,	Mūša
айпбах,,	Eipbach
джела,река,,	Gela_(river)
врбас,река,,	Vrbas_(river)
джиу,румыния,крайова,лупени,петрошани,тыргу-жиу	Jiu_River
бови,,bovey tracey,lustleigh,manaton,north bovey	River_Bovey
арикари,,	Arikaree_River
брента,,	Brenta_(river)
зюльц,,	Sülz_(river)
арру,река,,	Arroux
нура,казахстан,сарань	Nura_River
гёзель,,	Gösel
тойшниц,река,,	Teuschnitz_(Kremnitz)
пиньэйрус,река,,	Pinheiros_River
хальстенбах,,	Halstenbach_(Agger)
форт,река,шотландия,	River_Forth
поронай,россия,	Poronay_River
латорица,,	Latorica
фудзи,река,,	Fuji_River
гандак,тибет,багаха,нараянгарх (непал)	Gandaki_River
комоэ,река,кот-д’ивуар,	Komoé_River
большая горевая,,	Bolshaya_Gorevaya_River
абуна,река,боливия,	Abuna_River
кутсайоки,россия,	Kutsayoki_River
азерг,,	Azergues
китаками,река,,	Kitakami_River
марна,река,,	Marne_(river)
ирень,,	Iren_River
орд,река,,	Ord_River
биг-мадди,,	Big_Muddy_River
брюш,,	Bruche_(river)
бриде,южно-африканская республика,	Breede_River
мурн,река,,	River_Mourne
коне,река,,	Côney
каледон,река,лесото,	Caledon_River
брандбах,,	Brandbach
вёрбке,,	Wörbke
гельпе,,	Gelpe
семуа,река,,	Semois
рио-пулидо,,	Pulido_River
ворскла,,	Vorskla_River
пуя,,	Puya_River
орн,река,впадает в ла-манш,,	Orne_(river)
арканзас,река,соединённые штаты америки,пуэбло (город),талса,литл-рок (арканзас),форт-смит (арканзас),уичито	Arkansas_River
линненбеке,,	Linnenbeeke
искыр,,	Iskar_(river)
посьмак,,	Posmak_River
лос-анджелес,река,сан-фернандо (долина),лос-анджелес,бербанк (калифорния),комптон (калифорния),дауни (калифорния),глендейл (калифорния),лонг-бич	Los_Angeles_River
арахтос,,	Arachthos_(river)
сарда,,	Sharda_River
парок,,	Parok_River
ульфенбах,,	Ulfenbach
тимшор,,	Timsher_River
кузитрин,сьюард (полуостров),	Kuzitrin_River
кобожа,,	Kobozha_River
шешупе,,	Šešupė
гуапоре,река,боливия,	Guaporé_River
хёрзель,,	Hörsel
мальксе,,	Malxe
йёкюльсау-ау-фьёдлюм,исландия,	Jökulsá_á_Fjöllum
уэст-кетл,,	West_Kettle_River
сагами,река,,	Sagami_River
пай,река,таиланд,	Pai_River
хафербах,,	Haferbach
малый лип,,	Maly_Lip_River
илекса,река,впадает в водлозеро,,	Ileksa_River
фольме,,	Volme
ли,река,ирландия,,	River_Lee
соло,река,,	Solo_River
хундем,,	Hundem
черчилл,река,впадает в гудзонов залив,канада,	Churchill_River_(Hudson_Bay)
анакостия,река,соединённые штаты америки,	Anacostia_River
аре,,	Aare
шлиц,река,,	Schlitz_(river)
хенрис-форк,соединённые штаты америки,	Henrys_Fork_(Snake_River)
эна,река,,	Aisne_(river)
дрива,,	Driva
великая,река,впадает в псковское озеро,,	Velikaya_River
нун,река,,	Nun_River
нижняя тунгуска,россия,тура (красноярский край),туруханск,ербогачён (аэропорт)	Nizhnyaya_Tunguska_River
линт,,	Linth
алдан,река,,	Aldan_River
лауфах,река,,	Laufach_(river)
луангва,замбия,	Luangwa_River
пюттлах,река,,	Püttlach
белая,река,впадает в большую имандру,россия,	Belaya_River_(Imandra)
аллах-юнь,река,,	Allakh-Yun_River
бхадра,,	Bhadra_River
курарай,эквадор,	Curaray_River
мас,река,,	Maß_(Lauer)
ауграбен,,	Augraben_(Liederbach)
соломон,река,,	Solomon_River
йиглава,река,,	Jihlava_(river)
педедзе,,	Pededze
вайценбах,,	Waizenbach
наменлозе,,	Namenlose
салин,река,,	Saline_River_(Kansas)
пальмбах,река,,	Palmbach_(river)
журуэна,река,бразилия,	Juruena_River
намсен,норвегия,намсус	Namsen
брегальница,,	Bregalnica
фандарья,,	Fan_Darya
или,река,,	Ili_River
бразо,,	Brazeau_River
субарнарекха,индия,	Subarnarekha_River
тис,река,великобритания,,	River_Tees
уортингтон-крик,соединённые штаты америки,	Worthington_Creek
кау-кау,река,,	Cau-Cau_River
ауде-эйссел,,	Oude_IJssel
ло,река,,	Lot_(river)
виккербах,,	Wickerbach
горный тикич,,	Hirsky_Tikych
де-мойн,река,соединённые штаты америки,	Des_Moines_River
нидда,река,,	Nidda_(river)
цвестер-ом,,	Zwester_Ohm
эль-газаль,,	Bahr_el_Ghazal_River
навахо,река,,	Navajo_River
адур,,	Adour
а,река,соединённые штаты америки,сакраменто (калифорния)	American_River
лиммат,,	Limmat_(river)
шмерах,,	Schmerach
уай,уэльс,	River_Wye
у,река,,ушань (чунцин)	Wu_River_(Yangtze_River_tributary)
пассаде,река,,	Passade_(river)
оур,,	Our_(river)
мергбах,,	Mergbach
марица,река,,	Maritsa
верн,река,,	Wern
феллах,река,,	Fellach
барак,река,бангладеш,	Barak_River
гудзон,река,,populated places on the hudson river	Hudson_River
конуи,река,уэльс,конуи (город)	River_Conwy
эмсбах,,	Emsbach
шлемер-бах,,	Schleemer_Bach
агеда,река,португалия,	Águeda_(river)
сангро,,	Sangro
хёгенбах,,	Högenbach
биттеррут,,	Bitterroot_River
толлензе,,	Tollense
замбези,ангола,	Zambezi
рио-дульсе,река,впадает в мар-чикиту,,	Dulce_River_(Argentina)
отра,,	Otra
солотва,,	Sołotwa
лер,река,,	Leyre_(river)
оллигсбах,,	Olligsbach
кегуай-гранде,,	Queguay_Grande_River
лужнице,австрия,	Lužnice_(river)
вожега,река,,	Vozhega_River
игуара,,	Iguará_River
брайтбах,,	Breitbach_(Main)
начес,соединённые штаты америки,якима (город)	Naches_River
вендбах,,	Wendbach
вальдивия,река,,	Valdivia_River
чесапикский залив,,	Chesapeake_Bay
кандик,река,,	Kandik_River
визац,,	Wiesaz
песь,река,,	Pes_River
ангель,,	Angel_(river)
рио-негро,река,впадает в атлантический океан,неукен (провинция),неукен	Río_Negro_(Argentina)
картане,,	Karthane
хобек,река,,	Hoback_River
лимари,река,,	Limarí_River
кейла,река,,	Keila_(river)
репе,река,,	Repe
аконкагуа,река,,	Aconcagua_River
гуадалупе,река,впадает в алвисо,соединённые штаты америки,сан-хосе (калифорния)	Guadalupe_River_(California)
эльпе,,	Elpe
хейс,река,канада,	Hayes_River
барака,река,,	Barka_River
вилия,река,,	Neris
ябах,,	Jabach_(Agger)
омерсбах,река,,	Omersbach
колорадо,река,впадает в мексиканский залив,соединённые штаты америки,	Colorado_River_(Texas)
тий,,	Tille_(river)
тилигул,река,,	Tylihul_River
шмиттеборнер-бах,,	Schmitteborner_Bach
мен,река,,	Maine_(river)
гранд-ронд,соединённые штаты америки,elgin, oregon,la grande, oregon	Grande_Ronde_River
фиш-ривер,намибия,	Fish_River_(Namibia)
таиери,,	Taieri_River
уорбертон,река,,	Warburton_River
ларрис-крик,лайкоминг (округ, пенсильвания),	Larrys_Creek
эккельсбах,,	Eckelsbach
лаймбах,река,,	Leimbach_(Rhein-Neckar)
кура,азербайджан,гори,хашури,рустави,сабирабад,тбилиси	Kura_River
швабах,река,,	Schwabach_(Rednitz)
кикинг-хорс,канада,	Kicking_Horse_River
эльмбах,,	Elmbach
цяньцзян,,	Qian_River
нечако,канада,принс-джордж (британская колумбия)	Nechako_River
миттельрадде,,	Mittelradde
кисо,река,,	Kiso_River
латроб,река,австралия,	Latrobe_River
нюзим,,	Nyuzim_River
тулва,,	Tulva_River_(Russia)
орке,,	Orke
цойбах,,	Zeubach_(Wiesent)
туид,река,нортамберленд,	River_Tweed
ивалойоки,,	Ivalo_(river)
гандер,,	Gander_(Moselle)
опава,река,,	Opava_(river)
швайна,река,,	Schweina_(river)
хамбер,река,впадает в онтарио,канада,	Humber_River_(Ontario)
ямаска,река,канада,сент-иасент	Yamaska_River
везебах,,	Wesebach
модау,,	Modau
карповка,река,рукав,невы,,	Karpovka_River
мамоновка,река,впадает в балтийское море,,	Mamonovka
пуэрко,,	Puerco_River
белая вольта,буркина-фасо,	White_Volta
шмала,,	Schmala
вайда,река,,	Weida_(river)
оять,,	Oyat_River
кымган,республика корея,	Geum_River
кангша,бангладеш,	Kangsha_River
гёксу,,	Göksu
олеф,река,,	Olef
волинька,,	Volyňka
эллерзикер-бах,,	Ellersieker_Bach
гросер-козербах,,	Großer_Koserbach
сухобизярка,,	Sukhobizyarka_River
гросер-бастерграбен,,	Großer_Bastergraben
танаэльв,финляндия,	Tana_(Norway)
ваг,словакия,	Váh
тунгабхадра,,	Tungabhadra_River
пасленка,,	Pasłęka
тейлор,река,,	Taylor_River_(Colorado)
милк,река,канада,	Milk_River_(Alberta–Montana)
сент-клэр,река,,	St._Clair_River
стыр,,	Styr_River
авонмор,,	River_Avonmore
бронкс,река,соединённые штаты америки,	Bronx_River
бузан,,	Buzan_River
судома,,	Sudoma_River
кёллербах,,	Köllerbach_(Saar)
вологда,река,,	Vologda_River
писуэрга,,	Pisuerga
пенобскот,река,,	Penobscot_River
кубена,,	Kubena_River
азо,река,,	Aso_(river)
матаура,,	Mataura_River
молога,река,россия,	Mologa_River
ингул,,	Inhul
купарук,река,,	Kuparuk_River
сайото,,	Scioto_River
рио-гранде,река,впадает в карибское море,,	Río_Grande_de_Matagalpa
уфа,река,,	Ufa_River
рутенбах,,	Ruthenbach_(Ems)
эвасо-нгиро,,	Ewaso_Ng'iro
лаган,северная ирландия,лисберн,белфаст	River_Lagan
самбра,река,,	Sambre
леппе,,	Leppe
белый нил,южный судан,джинджа,джуба,хартум	White_Nile
южная кельтма,,	South_Keltma_River
дорнбах,,	Dornbach_(Eschbach)
льюта,,	Lluta_River
нанук,река,виктория,,	Nanook_River
халхин-гол,китайская народная республика,	Khalkhyn_Gol
мамер,река,,	Mamer_(river)
бейкер,река,,	Baker_River_(Chile)
нева,россия,кировск (ленинградская область),отрадное (город),санкт-петербург,шлиссельбург	Neva_River
варме-штайнах,,	Warme_Steinach
пангани,река,,	Pangani_River
петроуэ,,	Petrohué_River
махонинг,,	Mahoning_River
амаргоса,най (округ, невада),	Amargosa_River
ельчо,река,,	Yelcho_River
гранд-бален,,	Great_Whale_River
трюйер,,	Truyère
беличе,,	Belice
бецибука,мадагаскар,махадзанга	Betsiboka_River
арагуая,бразилия,	Araguaia_River
айхенвальдграбен,,	Eichenwaldgraben
мауле,река,,	Maule_River
нассах,,	Nassach_(Main)
тихуана,река,мексика,	Tijuana_River
ист-ривер,,	East_River
воллбах,,	Wollbach_(Baden)
пола,река,,	Pola_River
оре,река,,	Ohre
ирвелл,,	River_Irwell
о,река,,	Ohe_(Allna)
байльбах,,	Beilbach
экс,река,сомерсет,	River_Exe
уаитаки,река,новая зеландия,duntroon, new zealand,glenavy, new zealand,kurow,otematata	Waitaki_River
зуни,река,соединённые штаты америки,	Zuni_River
грюндлайнсбах,,	Gründleinsbach
гершпренц,,	Gersprenz
эрм,,	River_Erme
бартува,,	Bārta
шарженьга,,	Sharzhenga_River
южный буг,украина,	Southern_Bug
тапажос,бразилия,	Tapajós
аргунь,китайская народная республика,	Argun_River_(Asia)
ковда,река,россия,	Kovda_River
иден,река,,	River_Eden,_Cumbria
вува,россия,	Vuva_River
ди,река,впадает в ирландское море,англия,	River_Dee,_Wales
стрикленд,река,папуа — новая гвинея,	Strickland_River
лойзах,,	Loisach
криппенбах,,	Krippenbach
глимке,,	Glimke
карун,иран,	Karun
мохикан,,	Mohican_River
тимок,болгария,заечар,брегово,болгария,сербия	Timok_(river)
пленти,залив,новая зеландия	Bay_of_Plenty
уруп,река,,	Urup_River
северский донец,,	Donets
хусатоник,река,соединённые штаты америки,pittsfield, massachusetts	Housatonic_River
медебах,река,,	Medebach_(Orke)
гань,река,,	Gan_River_(Jiangxi)
ротес-вассер,,	Rotes_Wasser_(Ohm)
кукповрук,,	Kukpowruk_River
солокия,река,,	Solokiya_River
чулуутын-гол,монголия,	Chuluut_River
апалачикола,река,,	Apalachicola_River
кемь,река,впадает в белое море,,	Kem_River
водопадная,река,впадает в чёрное море,,	Uchan-su_(river)
дельта,река,,	Delta_River
р,река,россия,	Rova_River
евишовка,,	Jevišovka_(river)
моми,река,,	Maumee_River
джон-дей,соединённые штаты америки,	John_Day_River
ликинг,река,,	Licking_River_(Kentucky)
блес,,	Blees
оканоган,река,канада,келоуна,вернон (британская колумбия)	Okanogan_River
нирбах,,	Neismecke
кумано,река,,	Kumano_River
меттма,,	Mettma
руперт,река,канада,	Rupert_River
литл-снейк,,	Little_Snake_River
желча,река,,	Zhelcha_River
доддер,,	River_Dodder
уальяга,перу,	Huallaga_River
бельбо,,	Belbo
гланербек,,	Glanerbeek
уизер,река,соединённые штаты америки,	Weiser_River
уошито,река,впадает в тексому,,	Washita_River
каммель,,	Kammel
хоксбери,река,австралия,	Hawkesbury_River
куру-чу,,	Kuri_Chhu
чжошуйси,китайская республика,	Zhuoshui_River
рамокгвебана,,	Ramokgwebana_River
шпельтах,,	Speltach
ляпин,река,,	Lyapin_River
кахаба,река,соединённые штаты америки,	Cahaba_River
марано,,	Marano_(river)
большая мартайка,,	Bolshaya_Martayka_River
олдмен,,	Oldman_River
паро,река,,	Paro_Chhu
иттлингер-бах,,	Ittlinger_Bach
ваттер,,	Watter_(Twiste)
ангербах,,	Angerbach_(Rhein)
клута,,	Clutha_River
лауэр,,	Lauer_(river)
поркьюпайн,канада,	Porcupine_River
стрвяж,,	Strwiąż
хумахэ,китайская народная республика,	Huma_River_(Heilongjiang)
унструт,,	Unstrut
ишим,река,,	Ishim_River
шёпфебах,,	Schöpfebach
айсикл-крик,,	Icicle_Creek
пасторатсхофер-бах,,	Pastoratshofer_Bach
со,река,,	Saulx_(river)
пфримм,,	Pfrimm
резекне,река,,	Rēzekne_(river)
фон-дю-лак,канада,	Fond_du_Lac_River_(Saskatchewan)
виссер-бах,,	Wisser_Bach
кларк-форк,соединённые штаты америки,миссула,бьютт (монтана)	Clark_Fork_River
мальбергбах,,	Mahlbergbach
гаравог,,	River_Garavogue
шингу,бразилия,	Xingu_River
дойче-тайя,,	German_Thaya
эффельдер,река,,	Effelder_(river)
утроя,,	Utroya_River
дева,река,испания,	Deva_(river)
зиль,река,,	Sihl
ганг,бангладеш,буксар (город),хардвар,ришикеш,аллахабад,баллия,бхагалпур,гхазипур,хаджипур,канпур,мирзапур (город, индия),мунгер,патна,варанаси	Ganges
параиба-ду-сул,река,бразилия,	Paraíba_do_Sul
умпфер,,	Umpfer
ниуклук,,	Niukluk_River
швельге,,	Schwelge
дёрпе,,	Dörpe
зудбах,,	Sudbach
амба,река,впадает в амурский залив,,	Amba_River
билле,,	Bille_(Elbe)
хенне,река,,	Henne_(river)
туйкос,,	Tuykos_River
пилькомайо,река,аргентина,	Pilcomayo_River
наэ,река,,	Nahe_(river)
большой кундыш,,	Bolshoy_Kundysh_River
майами-ривер,,	Great_Miami_River
власина,,	Vlasina_(river)
бзыбь,,	Bzyb_River
желивка,,	Želivka
пунарбхаба,бангладеш,	Punarbhaba_River
сан-жуан-ду-параизу,река,,	São_João_do_Paraíso_River
эфце,,	Efze
редья,,	Redya_River
ландербах,,	Landerbach
у,река,колорадо,bonanza, utah,ouray, utah,meeker, colorado,rangely, colorado	White_River_(Green_River)
чалияр,река,ваянад,edavanna,nilambur,areekode	Chaliyar
чикаго,река,,	Chicago_River
литл-майами,,	Little_Miami_River
днепр,белоруссия,	Dnieper
крюккау,,	Krückau
льобрегат,,	Llobregat
ла-гранд,река,канада,	La_Grande_River
тиста,бангладеш,джалпайгури,калимпонг	Teesta_River
индигирка,,	Indigirka_River
рафт,река,соединённые штаты америки,	Raft_River
дистельбах,,	Diestelbach
мурат,река,,	Murat_River
катценбах,река,,	Katzenbach_(Neckar)
дзиндзу,,	Jinzū_River
вильде-гера,,	Wilde_Gera
менкебах,,	Menkebach
верфенер-бах,,	Werfener_Bach
вир,река,,	Vire_(river)
йонна,река,,	Yonne_(river)
норд,река,нидерланды,	Noord_(river)
клакамас,река,мэрион (округ, орегон),	Clackamas_River
айккумер-мюленбах,,	Eickumer_Mühlenbach
якима,река,,якима (город),ричленд (вашингтон)	Yakima_River
ресуз,,	Reyssouze_(river)
пиньос,пелопоннес,,	Pineios_(Peloponnese)
по,река,,	Po_(river)
пене,германия,	Peene
трисули,,	Trishuli_River
чибитка,,	Chibit_River
хоркера,река,,	Jorquera_River
ньиве-ватервег,нидерланды,	Nieuwe_Waterweg
барун,река,,	Barun_River
вельтерсбах,,	Weltersbach
люсбах,,	Lüßbach
токантинс,река,бразилия,	Tocantins_River
карапелле,река,,	Carapelle_(river)
онон,монголия,	Onon_River
ляохэ,китайская народная республика,	Liao_River
виловатая,река,впадает в белое море,,	Vilovataya_(river_flowing_into_White_Sea)
шошони,река,соединённые штаты америки,	Shoshone_River
д,река,россия,	Desna_River
бальсас,,	Balsas_River
дарт,река,англия,	River_Dart
фаренбах,река,,	Fahrenbach_(Rosbach)
штоффельсбергер-бах,,	Stoffelsberger_Bach
стикин,река,,	Stikine_River
хорлофф,,	Horloff
слаб-форк,соединённые штаты америки,	Slab_Fork
панфельд,,	Penfeld
платошинка,,	Platoshinka_River
нидэльва,река,впадает в северное море,,	Nidelva_(Aust-Agder)
триньо,,	Trigno
кассибиле,,	Cassibile_(river)
груттбах,,	Gruttbach
коколик,,	Kokolik_River
шандалар,,	Chandalar_River
бэйпаньцзян,,	Beipan_River
чено,,	Ceno
залах,река,,	Saalach
мезень,река,,	Mezen_River
чапаре,боливия,villa tunari	Chapare_River
каленбергер-бах,,	Bach_vom_Schlüsselgrund
зеннебах,,	Sennebach
укаяли,перу,	Ucayali_River
шешма,река,,	Sheshma_River
денмарк,река,,	Denmark_River
сёдр,,	Seudre
требишница,,	Trebišnjica
дунай,австрия,джурджу (город),русе,видин,кэлэраши,сулина (румыния)	Danube
сайлец,река,полк (округ, орегон),	Siletz_River
фельдкаль,река,,	Feldkahl
арнсбах,,	Arnsbach_(Usa)
птикодьяк,,дьеп (нью-брансуик),монктон	Petitcodiac_River
несс,,	River_Ness
е,река,венгрия,	Ier_River_(Barcău)
ч,река,канада,	Chilcotin_River
большой салым,,	Bolshoy_Salym_River
сылва,,	Sylva_River
студва,река,,	Studva
хуайхэ,китайская народная республика,	Huai_River
кильсбах,,	Kilsbach_(Gersprenz)
рансбах,,	Ransbach_(Lauer)
насс,река,канада,	Nass_River
индига,,	Indiga_River
шейверс-форк,,	Shavers_Fork
шпенгер-мюленбах,,	Spenger_Mühlenbach
эшенбек,,	Eschenbeek
гардон,,	Gardon
бразос,соединённые штаты америки,	Brazos_River
аттавапискат,канада,	Attawapiskat_River
западный дарт,англия,	West_Dart_River
логон,камерун,куссери	Logone_River
схёр,нидерланды,	Het_Scheur
телис-пирис,,	Teles_Pires
крумбехлайн,,	Krumbächlein
гуадиаро,испания,	Guadiaro_(river)
лопебах,,	Loopebach
лукуга,,	Lukuga_River
гнилой тикич,,	Hnyly_Tikych
хофебах,,	Hovebach
тефе,река,бразилия,	Tefé_River
клеппе,,	Kleppe_(Orpe)
тамир-гол,монголия,	Tamir_River
липпе,река,,	Lippe_(river)
тромъёган,,	Tromyogan_River
виппе,,	Wippe_(Rhedaer_Bach)
эсте,река,,	Este_(river)
эйссел,нидерланды,девентер,кампен (нидерланды),зютфен,зволле,дусбург (город)	IJssel
хайхэ,китайская народная республика,	Hai_River
харлебах,,	Harlebach
моченбах,,	Motschenbach
блинде-рот,,	Blinde_Rot
швинге,,	Schwinge_(Elbe)
трузе,,	Truse
майенн,река,,	Mayenne_(river)
лудербах,,	Luderbach
френчман,река,,	Frenchman_River
сан-педро,река,,	San_Pedro_River_(Guatemala)
бригах,,	Brigach
хольбах,,	Hohlbach_(Nidda)
дарлинг,река,австралия,menindee, new south wales,wilcannia,bourke, new south wales,wentworth, new south wales	Darling_River
брёль,,	Bröl
малый дюссель,,	Kleine_Düssel
проспект-крик,австралия,	Prospect_Creek_(New_South_Wales)
амазонка,бразилия,икитос,летисия	Amazon_River
гвадиана,,	Guadiana
флорида,река,,	Florida_River
этте,,	Ette_(river)
шегарка,река,россия,	Shegarka_River
малый чабис,,	Maly_Chabes_River
терек,,	Terek_River
пирита,река,,	Pirita_(river)
ред-дир,река,,	Red_Deer_River
стироне,,	Stirone
кафуэ,замбия,мазабука,кафуэ (город),китве-нкана	Kafue_River
мамфлас,,	Manflas_River
морача,черногория,	Morača
танаро,река,,	Tanaro
обь,россия,	Ob_River
метауро,,	Metauro
эльпенбах,,	Elpenbach
гакона,река,,	Gakona_River
ныса-клодзка,польша,	Nysa_Kłodzka
вирджин,dixie national forest,	Virgin_River
эннепе,,	Ennepe
вагенштайгбах,,	Wagensteigbach
леккнер-ах,,	Leckner_Ach
сояна,река,,	Soyana_River
ветлуга,река,,	Vetluga_River
сицзян,,	Xi_River
мамберамо,индонезия,	Mamberamo_River
воротан,,	Vorotan_(river)
литтфе,,	Littfe
траве,река,,	Trave
э,река,,	Eschbach_(Usa)
зикбах,,	Siekbach_(Werre)
баркэу,венгрия,маргита	Barcău_River_(Criș)
юкон,река,канада,	Yukon_River
элбоу,,	Elbow_River
лемон,река,,	River_Lemon
родинг,река,,илфорд	River_Roding
фузе,,	Fuhse
норренбергер-бах,,	Norrenberger_Bach
ялунцзян,китайская народная республика,	Yalong_River
кирнау,,	Kirnau
штригис,,	Striegis
фальме,,	Valme
б,река,,	Biała_(Vistula)
шмих,,	Schmiech
турия,река,испания,	Turia_(river)
орель,река,,	Oril
каликсэльвен,швеция,	Kalix_River
оулуйоки,финляндия,	Oulujoki
грюмпен,,	Grümpen_(river)
парнаиба,река,бразилия,	Parnaíba_River
лимпопо,ботсвана,	Limpopo_River
сей,река,,	Seille_(Moselle)
клондайк,река,канада,	Klondike_River
ваеньга,,	Vayenga_River
далэльвен,швеция,	Dalälven
петрус,река,,	Pétrusse
вахандарья,,	Wakhan_River
босна,река,босния и герцеговина,	Bosna_(river)
вильде-а,,	Wilde_Aa
чёрный эрнц,,	Black_Ernz
вуоснайоки,россия,	Vuosnayoki_River
бодрог,,	Bodrog
большой лип,,	Bolshoy_Lip_River
вис,река,,	Vis_(river)
варме,,	Warme
раба,река,,	Rába
шиталакшья,бангладеш,	Shitalakshya_River
боде,река,,	Bode_(river)
омулёвка,,	Omulyovka_River
эм,река,нидерланды,	Eem
шьер,,	Chiers
эррэр,,	Erer_River
водла,,	Vodla_River
арагон,река,,	Aragón_(river)
колласйоки,,	Kollaa_River
калькуррупе,,	Calcurrupe_River
нимс,,	Nims_(river)
смоки-хилл,,	Smoky_Hill_River
ройс,река,,	Reuss_(river)
фил,река,ирландия,	River_Feale
рио-гранде-де-сантьяго,,	Grande_de_Santiago_River
шпайербах,,	Speyerbach
р,река,бразилия,	Rio_Grande_(Paraná_River)
мостербах,,	Moosterbach
кретцер-бах,,	Kretzer_Bach
мулянка,река,,	Mulyanka_River
уаско,река,,	Huasco_River
шмаленхофер-бах,,	Schmalenhofer_Bach
сомма,река,,	River_Somme
биас,река,индия,	Beas_River
клайне-кинциг,,	Kleine_Kinzig
усекай,,	Usekay_River
эттернбах,,	Oetternbach
оттерсбах,,	Ottersbach
с,река,соединённые штаты америки,challis, idaho,salmon, idaho	Salmon_River_(Idaho)
футалеуфу,,	Futaleufú_River
хуанпуцзян,китайская народная республика,	Huangpu_River
калу-ганга,,	Kalu_River
тайтон,река,соединённые штаты америки,	Tieton_River
ротт,река,,	Rott_(river)
янцзы,китайская народная республика,	Yangtze
голубой нил,,	Blue_Nile
брембо,,	Brembo_(river)
луга,река,,	Luga_River
мурбах,,	Murbach_(Wupper)
чивейва,,	Chiwawa_River
моравице,,	Moravice_(river)
эльзофф,,	Elsoff_(river)
лидинг-крик,соединённые штаты америки,	Leading_Creek_(Little_Kanawha_River)
эльбекк,,	Ehlbeck_(Lopau)
яйва,река,,	Yayva_River
кауконахуа,,	Kaukonahua_River
зельвянка,река,,	Zel’vyanka_River
зварте-ватер,,	Zwarte_Water
сулак,река,,	Sulak_River
смит,река,калифорния,six rivers national forest,	Smith_River_(California)
бероунка,чехия,	Berounka
сан-хоакин,река,соединённые штаты америки,фресно,модесто,стоктон (калифорния)	San_Joaquin_River
редаэр-бах,,	Rhedaer_Bach
прохладная,река,,	Prokhladnaya_(river)
штайнфуртер-а,,	Steinfurter_Aa
мга,река,,	Mga_River
ландвассер,река,,	Landwasser_(river)
ном,река,,	Nome_River
передний рейн,,	Vorderrhein_(river)
керкербах,,	Kerkerbach
тирсо,,	Tirso_(river)
чёрная вольта,кот-д’ивуар,	Black_Volta
капуас,река,впадает в южно-китайское море,,	Kapuas_River
тель,река,,	Theel
огове,,	Ogooué_River
хилле,река,,	Hillebach
нит,река,впадает в ирландское море,,	River_Nith
шунтер,,	Schunter
малый куб,,	Maly_Kub_River
орпе,,	Orpe
тясмин,,	Tiasmyn_River
летавка,,	Lietauka
салаца,,	Salaca
тэдонган,,	Taedong_River
арно,река,впадает в гудзонов пролив,канада,	Arnaud_River
алсей,лейн (округ, орегон),	Alsea_River
сен-шарль,река,,	Saint-Charles_River
ага,река,,	Aga_River
лантерн,,	Lanterne_river
ю,река,,	Jūra
маныч,,	Manych_River
урк,река,,	Ourcq
беккендорфер-мюленбах,,	Beckendorfer_Mühlenbach
молчадь,река,,	Molchad_River
тульба,,	Thulba
о,река,испания,	Odra_(Pisuerga)
нестукка,река,тилламук (округ, орегон),	Nestucca_River
пизь,,	Piz_River
мутала,река,швеция,	Motala_ström
афгедамде-маас,,	Afgedamde_Maas
лиард,река,канада,	Liard_River
н,река,,	Nyariz_River
эдельбах,,	Edelbach
айтра,,	Eitra
кичменьга,,	Kichmenga_River
бэйцзян,,	Bei_River
риони,грузия,	Rioni_River
вербах,река,,	Wehrbach_(Nidda)
биберс,,	Bibers
туул,монголия,	Tuul_River
финкельбах,,	Finkelbach
маркем,река,папуа — новая гвинея,	Markham_River
сир,река,,	Syre
лим,,	Lim_(river)
альна,,	Allna
устья,,	Ustya_River
чусовая,,	Chusovaya_River
неффельбах,,	Neffelbach
жутаи,река,бразилия,	Jutai_River
шушве,,	Šušvė
щара,,	Shchara_River
платани,река,,	Platani_(river)
сулия,река,колумбия,	Zulia_River
бицценбах,,	Bizzenbach
хорол,река,,	Khorol_River
логан,река,соединённые штаты америки,	Logan_River_(Utah)
коко,река,гондурас,	Coco_River
урубамба,река,перу,	Urubamba_River
вайль,река,,	Weil_(river)
вунаскватакет,,	Woonasquatucket_River
джорджес,австралия,	Georges_River
покшеньга,,	Pokshenga_River
клайне-бах,,	Kleinebach
цвиккауэр-мульде,,	Zwickau_Mulde
пчёвжа,река,,	Pchyovzha_River
г,река,соединённые штаты америки,кент (вашингтон)	Green_River_(Duwamish_River)
кальчик,река,,	Kalchik_River
мира,река,,	Mira_River_(Portugal)
дёма,россия,	Dyoma_River
анадырь,река,,	Anadyr_River
джелам,река,,	Jhelum_River
большой черемшан,,	Bolshoy_Cheremshan_River
харрикана,река,,	Harricana_River
сент-джонс,река,индиан-ривер (округ, флорида),палатка (флорида),делтона,джэксонвилл,ориндж-парк (флорида)	St._Johns_River
норт-платт,соединённые штаты америки,ларами (вайоминг),каспер (вайоминг),норт-платт (небраска),скотсблафф (небраска)	North_Platte_River
с,река,соединённые штаты америки,	Spring_Creek_(Little_Kanawha_River)
ахерон,,	Acheron
м,река,,	Möhlin_(Rhine)
брегенцер-ах,,	Bregenzer_Ache
влтава,чехия,	Vltava
магра,,	Magra_(river)
грон,словакия,	Hron
северная сосьва,россия,	Severnaya_Sosva_River
дюррайх,,	Dürreych
дерри,река,,	River_Derry
андерсон,река,,	Anderson_River_(Northwest_Territories)
западная морава,,	West_Morava
к,река,карибу (плато),	Cariboo_River
рио-тинто,испания,	Rio_Tinto_(river)
масселшелл,,	Musselshell_River
ветерница,,	Veternica
удай,река,,	Uday_River
блаве,река,,	Blavet
молмыс,река,,	Molmys_River
кейп-фир,река,,	Cape_Fear_River
уверь,,	Uver_River
новитна,река,,	Nowitna_River
алфей,река,,	Alfeios
бак,река,канада,	Back_River
педиэос,,	Pedieos
молопо,ботсвана,	Molopo_River
савала,,	Savala_River
припять,река,,	Pripyat_River
локлан,австралия,	Lachlan_River
тигарт,соединённые штаты америки,	Tygart_Valley_River
вынгапур,,	Vyngapur_River
уаиау,,	Waiau_River_(Southland)
наревка,река,белоруссия,	Narewka_(river)
волошка,река,,	Voloshka_River
джордан,река,юта (округ, юта),	Jordan_River_(Utah)
дияла,река,,	Diyala_River
мирна,река,впадает в адриатическое море,хорватия,мотовун,новиград (истрия)	Mirna_(Croatia)
рутка,,	Rutka_River
большой куб,,	Bolshoy_Kub_River
пекос,река,соединённые штаты америки,	Pecos_River
шелонь,,	Shelon_River
люцзян,,	Liu_River
тигода,река,,	Tigoda_River
гевингхаузер-бах,,	Gewinghauser_Bach
пейетт,река,,emmett, idaho	Payette_River
дебед,река,,	Debed
аксу,река,впадает в балхаш,,	Aksu_River_(Kazakhstan)
оша,,	Osha_River
колорадо,река,мексика,сан-луис-рио-колорадо,юма (аризона),моаб (юта),гленвуд-спрингс,гранд-джанкшен (колорадо),лейк-хавасу-сити	Colorado_River
ирминио,,	Irminio
собат,южный судан,	Sobat_River
култым,,	Kultym_River
глане,,	Glane_(Ems)
риу-негру,река,бразилия,	Rio_Negro_(Amazon)
л,река,,	Lewis_River_(Wyoming)
мус,река,впадает в гудзонов залив,,	Moose_River_(Ontario)
фойербах,река,,	Feuerbach_(Neckar)
верман,река,,	Verman_River
асовка,,	Asovka_River
вублиц,,	Wublitz
керженец,,	Kerzhenets_River
теймар,река,тасмания,,	Tamar_River
прут,молдавия,кагул (город),черновцы,леова,унгень,коломыя	Prut
д,река,соединённые штаты америки,	D_River
баро,река,,	Baro_River
осте,река,,	Oste
берёзовка,река,впадает в чусовское озеро,,	Beryozovka_River_(Perm_Krai)
вертах,река,,	Wertach_(river)
дэлгэр-мурен,монголия,	Delgermörön
унтройе,река,,	Untreue
рикк,,	Ryck
дольбек,,	Dollbek
фульда,река,,	Fulda_(river)
гельсбах,,	Gehlsbach_(river)
греннельбах,,	Grennelbach
асопардо,,	Azopardo_River
сюнь,река,,	Syun_River
литл-бигхорн,,	Little_Bighorn_River
нагара,река,,	Nagara_River
оделока,алгарви,	Odelouca_River
велс,река,,	Vels_River
шёнбах,река,,	Schönbach_(river)
молдова,река,румыния,роман (румыния),кымпулунг-молдовенеск	Moldova_River
эбола,река,демократическая республика конго,	Ebola_River
элефантес,мозамбик,	Olifants_River_(Limpopo)
амме,,	Amme
кауто,река,,	Cauto_River
камаронес,река,,	Camarones_River
висла,польша,	Vistula
фребах,,	Freebach
кальекалье,,	Calle-Calle_River
чжуцзян,китайская народная республика,	Pearl_River_(China)
долорес,река,колорадо,	Dolores_River
комати,мозамбик,	Komati_River
альтмюль,,	Altmühl
ине,река,,	Ihne
хоэнштайнербах,,	Hohensteinerbach
буриганга,бангладеш,	Buriganga_River
нагольд,река,,	Nagold_(river)
темс,река,впадает в сент-клэр,канада,	Thames_River_(Ontario)
туне,река,,	Thune_(river)
иордан,израиль,	Jordan_River
кисуца,,	Kysuca
мохок,река,онайда (округ, нью-йорк),скенектади,ютика (нью-йорк)	Mohawk_River
веме,река,бенин,	Ouémé_River
прюм,река,,	Prüm_(river)
шаше,,	Shashe_River
хьерадсвётн,,	Héraðsvötn
малая соль,,	Malaya_Sol_River
сямжена,,	Syamzhena_River
коппермайн,канада,	Coppermine_River
ховд,река,монголия,	Khovd_River
пьедра,,	Piedra_River_(Colorado)
лаука,боливия,	Lauca_River
малая белая,река,впадает в имандру,россия,	Malaya_Belaya_River_(Imandra)
кенай,река,,	Kenai_River
альме,река,,	Alme_(river)
эрнстбах,,	Ernstbach
линдларер-зюльц,,	Lindlarer_Sülz
т,река,,	Turija_River
яркон,израиль,тель-авив	Yarkon_River
шаква,,	Shakva_River
пясина,россия,	Pyasina_River
раритан,река,соединённые штаты америки,	Raritan_River
флиде,,	Fliede
гуавьяре,,	Guaviare_River
иргина,,	Irgina_River
сан-марино,река,,	San_Marino_(river)
даме,река,,	Dahme_(river)
салуин,китайская народная республика,	Salween_River
валира,река,андорра,	Gran_Valira
чиндуин,река,,	Chindwin_River
кохер,река,,	Kocher
судость,,	Sudost_River
меркенфритцербах,,	Merkenfritzerbach
пырыл-афинелор,румыния,	Pârâul_Afinelor
эртиль,река,россия,	Ertil_River
алоля,,	Alolya_River
харт,река,,	Heart_River_(Wyoming)
вандея,река,,	Vendée_(river)
грейт-уз,великобритания,	River_Great_Ouse
напа,река,,напа (калифорния)	Napa_River
орб,река,впадает в средиземное море,,	Orb_(river)
скерн-о,дания,	Skjern_River
ане,ручей,	Ahne_(Fulda)
таскаровас,соединённые штаты америки,	Tuscarawas_River
любляница,,	Ljubljanica
вальдбрёльбах,,	Waldbrölbach
лайсе,,	Leiße
лосмина,россия,сычёвка	Losmina_River
северн,,	River_Severn
кришул-алб,венгрия,брад,дьюла (город)	Crișul_Alb_River
шкотовка,,	Shkotovka_River
экаллук,,	Ekalluk_River
тёс,река,,	Töss_(river)
вайсах,река,,	Weißach_(Bregenzer_Ach)
гильгбах,,	Gilgbach
холлерграбен,,	Hollergraben
хор,река,,	Khor_River
роско,река,,	Roscoe_River
дюранс,,	Durance
вазуза,,	Vazuza_River
скина,река,канада,terrace, british columbia	Skeena_River
флэбах,,	Flehbach
жаманшин,река,бразилия,	Jamanxim_River
западная лица,река,россия,	Zapadnaya_Litsa_River
харама,испания,	Jarama
радбуза,чехия,	Radbuza
лек,река,нидерланды,	Lek_(river)
фронхаузер-бах,,	Frohnhauser_Bach
нарым,река,,	Narym_River
мадре-де-дьос,река,боливия,	Madre_de_Dios_River
барыч,река,,	Barycz
меджерда,,	Medjerda_River
имджа-кхола,,	Imja_Khola
фергусон,река,,	Ferguson_River_(Nunavut)
сав,,	Save_(Garonne)
клерф,,	Clerve
каратал,река,,	Karatal_River
вишерка,,	Visherka_River
чонг-кемин,киргизия,	Chong-Kemin_River
баккильоне,,	Bacchiglione
ольо,,	Oglio
с,река,,	Surya_River
лири,река,,	Liri
нервьон,испания,	Nervión
бердекин,река,австралия,	Burdekin_River
зане,,	Saane/Sarine
абакан,река,россия,абакан,абаза (город)	Abakan_River
квичак,,	Kvichak_River
хантайка,,	Khantayka_River
ялуцзян,китайская народная республика,	Yalu_River
орава,река,словакия,	Orava_(river)
шледде,,	Schledde_(Ahse)
п,река,россия,	Plavitsa_River
миния,,	Minija
эхсарау,,	Öxará
брабекке,,	Brabecke_(Valme)
унтере-арген,,	Untere_Argen
швельме,,	Schwelme
митува,,	Mituva
десагуадеро,река,впадает в уру-уру,боливия,оруро	Desaguadero_River_(Bolivia)
клайне-а,,	Kleine_Aa_(Aabach)
вахбах,,	Wachbach
амуд,,	Nahal_Amud
куара,,	Kuara_River
вайлах,,	Weilach
апфельштедт,река,,	Apfelstädt_(Gera)
жавари,перу,	Javary_River
ала-арча,река,киргизия,бишкек	Ala-Archa_River
малур,река,соединённые штаты америки,	Malheur_River
тикуго,река,,	Chikugo_River
рио-колорадо,аргентина,	Colorado_River_(Argentina)
остравице,чехия,	Ostravice_(river)
нотець,польша,	Noteć
севр-нантез,,	Sèvre_Nantaise
веттер,река,,	Wetter_(river)
ганнисон,,гранд-джанкшен (колорадо)	Gunnison_River
копьяпо,река,,	Copiapó_River
ипель,венгрия,	Ipeľ
чарльз,река,соединённые штаты америки,бостон,кембридж (массачусетс)	Charles_River
хелльбах,,	Hellbach
солтлик-крик,соединённые штаты америки,	Saltlick_Creek_(Little_Kanawha_River)
штоккхаймер-бах,,	Stockheimer_Bach
кельстер,,	Kelster
красна,венгрия,матесалька,шимлеу-силванией	Crasna_River_(Tisza)
миссинайби,река,канада,	Missinaibi_River
вытегра,река,,	Vytegra_River
бахзайфен,,	Bachseifen
нуте,,	Nuthe
айстрингхаузер-бах,,	Eistringhauser_Bach
ота,река,,	Ōta_River
адда,,	Adda_(river)
тогиак,река,,	Togiak_River
сан-хуан,река,впадает в карибское море,,	San_Juan_River_(Nicaragua)
крокер,река,,	Croker_River
вильгельмсталер-бах,,	Wilhelmstaler_Bach
цетина,,	Cetina
анимас,соединённые штаты америки,	Animas_River
гильменд,река,,	Helmand_River
утва,,	Utva_River_(Ural)
шлингенбах,,	Schlingenbach
висте,,	Wieste
ахелоос,,	Achelous_River
тунга,индия,	Tunga_River
бидасоа,,	Bidasoa
вид,река,,	Wied_(river)
тимиш,река,румыния,	Timiș_River
арланса,испания,	Arlanza_(river)
яуза,,	Yauza_River
севир,река,,	Sevier_River
хиллерсбах,,	Hillersbach
карес,река,,кабралес	Cares
петтерил,,карлайл (англия)	River_Petteril
нил,южный судан,каир,джинджа,джуба,хартум	Nile
пак,река,впадает в панд-орей,,	Pack_River
гаухсбах,,	Gauchsbach
таро,река,,	Taro_(river)
миттлере-эбрах,,	Mittlere_Ebrach
куолайоки,финляндия,	Kuolajoki
хыонг,вьетнам,хюэ	Perfume_River
онгерманэльвен,швеция,	Ångerman
драк,,	Drac_(river)
ардеш,река,,	Ardèche_(river)
миссури,река,монтана,су-сити,канзас-сити (миссури),сент-луис,бисмарк (северная дакота),грейт-фолс,канзас-сити (канзас),омаха,пирр (южная дакота)	Missouri_River
купфербах,,	Kupferbach_(Berka)
гёула,река,впадает в норвежское море,,	Gaula_(Sør-Trøndelag)
золотоношка,река,украина,	Zolotonoshka_River
федербах,,	Federbach_(Alb)
алгама,,	Algama_River
гхагхра,китайская народная республика,	Ghaghara
кочечум,россия,тура (красноярский край)	Kochechum_River
миттельбах,,	Mittelbach_(Werre)
фихтбах,,	Vichtbach
вачаган,река,,	Vachagan_River
раджанг,малайзия,	Rajang_River
чугрум,,	Chugrum_River
штрой,,	Streu_(Franconian_Saale)
карони,,	Caroní_River
сухар,река,,	Zújar_River
айхельбах,германия,	Eichelbach_(Nidda)
вилен,река,,	Vilaine
швебише-рецат,,	Schwäbische_Rezat
брухт,,	Brucht
реченбах,,	Retschenbach
листер,река,,	Lister_(river)
динкель,,	Dinkel
панд-орей,река,канада,sandpoint, idaho	Pend_Oreille_River
олона,река,,	Olona
флай,река,индонезия,	Fly_River
дисна,река,,	Dysna
шмельцбах,,	Schmelzbach
красная вольта,буркина-фасо,	Red_Volta
трент,река,великобритания,	River_Trent
спей,река,,	River_Spey
вааль,южно-африканская республика,	Vaal_River
кюльбах,,	Kühlbach
нижняя тойма,,	Nizhnyaya_Toyma_River
большая высь,,	Velyka_Vys
газимур,,	Gazimur_River
титон,река,айдахо,соединённые штаты америки,	Teton_River_(Idaho)
збруч,,	Zbruch_River
усумасинта,гватемала,	Usumacinta_River
бруней,река,,	Brunei_River
осым,,	Osam
кобук,река,соединённые штаты америки,	Kobuk_River
мула,река,испания,	Mula_(Spain)
миньо,река,португалия,луго,оренсе	Minho_(river)
коххарт,,	Kochhart
отава,,	Otava_(river)
драй-форк,соединённые штаты америки,harman, west virginia,hendricks, west virginia	Dry_Fork_(Cheat_River)
агусан,филиппины,	Agusan_River
нойо,соединённые штаты америки,	Noyo_River
шполебах,,	Spolebach
штепениц,,	Stepenitz_(Brandenburg)
аск,река,уэльс,	River_Usk
пурус,бразилия,	Purus_River
янгон,река,,	Yangon_River
арагви,грузия,	Aragvi_River
дадухэ,,	Dadu_River_(Sichuan)
ренх,,	Rench
литл-канова,,	Little_Kanawha_River
большая лиахви,,	Greater_Liakhvi_River
гросер-диккфлус,,	Großer_Dieckfluss
пьяве,,	Piave_(river)
смоки,река,,	Smoky_River
уобаш,река,,	Wabash_River
веггентальбах,,	Weggentalbach
малый заб,иран,	Little_Zab
ниагара,,	Niagara_River
циевна,река,,	Cem_(river)
инирида,река,,	Inírida_River
ле,,	Lee_(Vechte)
лумда,,	Lumda_(river)
три,река,,	Tree_River
бойсе,река,соединённые штаты америки,	Boise_River
свияга,,	Sviyaga_River
гласс,река,остров мэн,дуглас (остров мэн)	River_Glass,_Isle_of_Man
боккхорнер-бах,,	Bockhorner_Bach
вайсмайн,река,,	Weismain_(river)
юснан,швеция,	Ljusnan
бхагиратхи,индия,	Bhagirathi_River
багебах,,	Baagebach
осейдж,река,соединённые штаты америки,tuscumbia, missouri,warsaw, missouri,lake ozark, missouri	Osage_River
оти,река,бенин,	Oti_River
уш,река,,	Ouche
абэ,река,,	Abe_River
шяшувис,,	Šešuvis
эспе,река,,	Espe_(Fulda)
дильсбах,,	Dilsbach
сок,река,,	Sok_River
снейк,соединённые штаты америки,туин-фолс (город, айдахо),американ фолс,блэкфут (город, айдахо),берли (айдахо),айдахо-фолс,льюистон (айдахо)	Snake_River
ирири,бразилия,	Iriri_River
фельда,,	Felda_(Ohm)
полота,река,,	Palata_River
иббенбюренер-а,,	Dreierwalder_Aa
флинцбах,,	Flinzbach
анвик,река,,	Anvik_River
пенжина,река,,	Penzhina_River
эльс,,	Els_(Rhön)
саванна,река,соединённые штаты америки,огаста (джорджия),саванна (джорджия)	Savannah_River
биг-вуд,блейн (округ, айдахо),кетчум,сан-валли (айдахо)	Big_Wood_River
себольяти,река,,	Cebollatí_River
примс,,	Prims
жеймяна,река,,	Žeimena
клебах,,	Kleebach
пёппельше,,	Pöppelsche
желонь,,	Zhelon
мозелот,,	Moselotte
кама,,	Kama_River
кыма,,	Kyma_River
а,река,непал,	Arun_River,_China-Nepal
сейхан,река,турция,адана	Seyhan_River
гросе-фильс,,	Große_Vils
лайтенбах,,	Leitenbach
визекк,,	Wieseck_(river)
куроне,,	Curone
ред-ривер,река,впадает в виннипег,,гранд-форкс (северная дакота),селкирк (манитоба),виннипег,фарго (северная дакота)	Red_River_of_the_North
беркель,,	Berkel
варене,,	Varėnė
каньо-кристалес,колумбия,	Caño_Cristales
рётенбах,река,,	Rötenbach_(Kinzig)
сочи,река,,	Sochi_River
дубиса,,	Dubysa
хава,россия,	Khava_River
ноймаген,,	Neumagen
сэнди,река,клакамас (округ, орегон),	Sandy_River_(Oregon)
ашит,река,,	Ashit_River
уиниск,река,канада,	Winisk_River
ешильырмак,,	Yeşilırmak_River
пар,река,,	Paar
гизель,река,,	Giesel_(Fulda)
севр-ньортез,,	Sèvre_Niortaise
сиеве,,	Sieve_(river)
литл-сайото,,	Little_Scioto_River_(Ohio_River)
брахмапутра,бангладеш,гувахати	Brahmaputra_River
саба,река,,	Saba_River
финлей,река,,	Finlay_River
эбро,испания,	Ebro
овайхи,река,соединённые штаты америки,	Owyhee_River
кромбах,река,,	Krombach_(river)
аверон,река,,	Aveyron_(river)
чёрный дрин,,	Black_Drin
истра,река,,	Istra_River
олимар-гранде,,	Olimar_Grande_River
нишава,,	Nišava
лежа,река,,	Lezha_River
к’аппель,,	Qu'Appelle_River
китенска,,	Karaagach_(river)
зальцбёде,,	Salzböde
небель,река,,	Nebel_(river)
эро,река,,	Hérault_(river)
коллау,,	Kollau_(Tarpenbek)
близ,река,,	Blies
арга,река,испания,памплона	Arga_(river)
тымь,россия,	Tym_River,_Sakhalin
селеннях,,	Selennyakh_River
афрам,гана,	Afram_River
фицрой,река,впадает в коралловое море,,	Fitzroy_River_(Queensland)
делавэр,река,соединённые штаты америки,камден (нью-джерси),филадельфия,трентон (нью-джерси),уилмингтон (делавэр)	Delaware_River
халлербах,,	Hallerbach_(Holtebach)
асида,река,,	Ashida_River
мадейра,река,бразилия,борба (амазонас),умайта (амазонас)	Madeira_River
сава,босния и герцеговина,брчко (город)	Sava
раппаханнок,река,,	Rappahannock_River
крутыня,,	Krutynia
перетна,,	Peretna_River
уайт-кей,южно-африканская республика,	Wit-Kei_River
сепик,река,индонезия,	Sepik
луза,река,,	Luza_River
шкумбини,,	Shkumbin
пукшеньга,,	Pukshenga_River
доллабарат,португалия,	Dollabarat
лис,река,,	Leie
рено,река,,	Reno_(river)
намербах,,	Nahmerbach
кокшеньга,,	Kokshenga_River
фицрой,река,впадает в индийский океан,,	Fitzroy_River_(Western_Australia)
савлек,,	Savlek_River
рузизи,река,бурунди,	Ruzizi_River
ширвинта,,	Širvinta
апуримак,перу,	Apurímac_River
айах,,	Eyach_(Enz)
барбах,,	Baarbach
литл-вуд,соединённые штаты америки,	Little_Wood_River
траки,река,,	Truckee_River
зельценбах,,	Selzenbach
бёрнт,река,соединённые штаты америки,	Burnt_River_(Oregon)
ферндорфбах,,	Ferndorfbach
зибенбах,река,,	Siebenbach_(river)
шуа,,	Sjoa
кунгур,река,,	Kungur_River
синано,река,,	Shinano_River
айова,река,,	Iowa_River
шерцах,,	Scherzach
амударья,афганистан,	Amu_Darya
вельзе,,	Welse
красна-веке,венгрия,	Crasna_Veche_River
циммербах,,	Zimmerbach_(Starzel)
чорох,,	Çoruh_River
нискуалли,соединённые штаты америки,	Nisqually_River
чане,река,,	Ciane
везер,германия,минден,бремерхафен,хамельн,ганн. мюнден,бремен,кассель,фульда (река)	Weser
канцельбах,,	Kanzelbach
ванненбах,,	Wannenbach
тудовка,,	Tudovka_River
с,река,канада,переписное деление юкона,мейо (юкон)	Stewart_River
камчия,,	Kamchiya
адидже,больцано (провинция),ора (провинция больцано)	Adige
швальбах,река,,	Schwalbach_(Sulzbach)
он,река,,	Aulne
пьюджет-саунд,,бремертон,олимпия (вашингтон),эверетт (вашингтон)	Puget_Sound
маккензи,река,канада,форт-провиденс,форт-симпсон,норман-уэлс	Mackenzie_River
т,река,австралия,	Thomson_River_(Victoria)
залвай,,	Salwey
лызовка,,	Lyzovka_River
лемпе,,	Lempe
зойльбах,,	Seulbach
рапти,река,,	West_Rapti_River
вембах,река,,	Wembach_(Gersprenz)
хафель,,	Havel
остер,ручей,	Oster_(Blies)
зиндерсбах,,	Sindersbach
канкай,индия,	Kankai_River
бехлесбах,,	Bächlesbach
баунах,река,,	Baunach_(river)
крумм,,	Krumm_(river)
гёта-эльв,,	Göta_älv
мара,река,кения,	Mara_River
авока,река,ирландия,,	River_Avoca
бизярка,,	Bizyarka_River
куэйрас,,	Cuieiras_River
шексна,река,,	Sheksna_River
телон,река,канада,	Thelon_River
эльнхаузер-вассер,,	Elnhauser_Wasser
маттава,река,канада,	Mattawa_River
портнёф,река,соединённые штаты америки,	Portneuf_River_(Idaho)
баппагай,,	Bappagay_River
бладвейн,канада,	Bloodvein_River
чи,река,,	Chi_River
мэри,река,,	Mary_River_(Queensland)
андийское койсу,,	Andi_Koysu
сегура,река,,	Segura
халон,река,испания,	Jalón_(river)
хённиге,,	Hönnige_(Wupper)
дак-ривер,,	Duck_River_(Tennessee)
айтер,,	Eiter
люи,река,,	Luy
пружёнка,россия,	Pruzhonka_River
рамеде,,	Rahmede
лена,россия,	Lena_River
нихалем,река,соединённые штаты америки,	Nehalem_River
мета,река,,	Meta_River
урфт,река,,	Urft_(river)
нантикок,река,,	Nanticoke_River
кататумбо,колумбия,	Catatumbo_River
когыльник,,	Cogalnic_River
каяанинйоки,,	Kajaani_(river)
пиуза,,	Piusa_(river)
кромме-рейн,нидерланды,	Kromme_Rijn
голо,,	Golo_(river)
савиня,,	Savinja
лембах,река,,	Lembach_(Schwalm)
грумбах,,	Grumbach_(Werra)
рис,река,,	Riss
мерримак,река,соединённые штаты америки,конкорд (нью-гэмпшир),лоренс (массачусетс),лоуэлл (массачусетс),манчестер (нью-гэмпшир),нашуа (нью-гэмпшир)	Merrimack_River
агано,река,,	Agano_River
ыгыатта,,	Ygyatta_River
лихтебах,,	Lichtebach
обере-арген,,	Obere_Argen
аниак,река,,	Aniak_River
вашка,река,,	Vashka_River
пасиг,река,филиппины,	Pasig_River
роанок,река,соединённые штаты америки,	Roanoke_River
медем,река,,	Medem
терешка,,	Tereshka_River
вердон,река,,	Verdon_(river)
фортескью,река,,	Fortescue_River
фьюме-гранде,,	Grande_River_(Sicily)
бист,река,,	Bist_(river)
дрина,,	Drina
лан,река,,	Lahn
пасак,река,,	Pa_Sak_River
людер,река,,	Lüder_(river)
мерси,река,большой манчестер,	River_Mersey
