ольба,испания,Ольба	Olba,_Aragon
орхон,монголия,булган,Орхон 	Orkhon,_Bulgan
оливар,чили,посёлок,чили,Оливар 	Olivar
орловский район,россия,посёлок,ростовский область,Орловский район 	Orlovsky_District,_Rostov_Oblast
отейру,португалия,район,браганса,Отейру 	Outeiro_(Bragança)
обервезер,германия,коммуна,Обервезер	Oberweser
оэ,бельгия,бельгия,коммуна,Оэ 	Ohey
опочный,польша,город,Опочно	Opoczno
ойорредондо,испания,Ойорредондо	Hoyorredondo
ольдендорф,германия,коммуна,гольштейн,Ольдендорф 	Oldendorf,_Schleswig-Holstein
ормайстега,испания,населённый пункт,Ормайстеги	Ormaiztegi
отрадный,россия,Отрадный	Otradny,_Samara_Oblast
обда,австрия,Обдах	Obdach
ондарроа,испания,Ондарроа	Ondarroa
олд-оттава-истый,канада,Олд-Оттава-Ист	Old_Ottawa_East
оттеншлаг-они-мюлькрайс,австрия,коммуна,Оттеншлаг-им-Мюлькрайс	Ottenschlag_im_Mühlkreis
охтерзум,германия,коммуна,Охтерзум	Ochtersum
орзинген-ненцинген,германия,община,Орзинген-Ненцинген	Orsingen-Nenzingen
ометепек,мексика,город,Ометепек	Ometepec
орленбах,германия,коммуна,Орленбах	Orlenbach
остроленка,польша,город,Остроленка	Ostrołęka
олье-маринья,португалия,Олью-Маринью	Olho_Marinho
орльяк-де-бар,франция,коммуна,Орльяк-де-Бар	Orliac-de-Bar
остров рузвельт,соединять штат америка,нью-йорк,Остров Рузвельта 	Roosevelt_Island
оффенбург,германия,город,Оффенбург	Offenburg
отопать,греция,остров,Отони	Othonoi
оффлаг,италия,коммуна,Оффлага	Offlaga
ондангва,намибия,город,Ондангва	Ondangwa
оберрасть,германия,коммуна,Оберраден	Oberraden
окенвиль,франция,коммуна,Окенвиль	Auquainville
оровилла,соединять штат америка,калифорния,город,Оровилл 	Oroville,_California
оловить,чехия,город,чехия,Олови 	Oloví
олдершот,великобритания,Олдершот	Aldershot
оливарес,испания,андалусия,населённый пункт,Оливарес 	Olivares,_Spain
огузель,турция,город,Огузели	Oğuzeli
оркахо,испания,муниципалитет,Оркахо	Orcajo
обергрисбах,германия,коммуна,Обергрисбах	Obergriesbach
оломоуц,чехия,город,Оломоуц	Olomouc
ока-гров,соединять штат америка,город,миннесота,Ок-Гров 	Oak_Grove,_Minnesota
ондскот,франция,коммуна,Ондскот	Hondschoote
ормонт,германия,коммуна,Ормонт	Ormont
оттендорф,германия,коммуна,тюрингия,Оттендорф 	Ottendorf,_Thuringia
особлаго,чехия,муниципалитет,Особлага 	Osoblaha
озолниека,латвия,Озолниеки	Ozolnieki
орехов,украина,город,Орехов 	Orikhiv
орловский район,россия,кировский область,город,Орловский район 	Orlovsky_District,_Kirov_Oblast
олдкасл,ирландия,Олдкасл	Oldcastle,_County_Meath
остерхаузен,германия,айслебен,коммуна,Остерхаузен 	Osterhausen
ольгинский район,россия,Ольгинский район	Olginsky_District
оберн,соединять штат америка,кентукки,Оберн 	Auburn,_Kentucky
олевать-суль-тушать,италия,коммуна,Олевано-суль-Тушано	Olevano_sul_Tusciano
орск,россия,город,Орск	Orsk
остерренфельд,германия,коммуна,Остеррёнфельд	Osterrönfeld
оренкль,франция,коммуна,Оренкль	Orincles
орсонья,италия,коммуна,Орсонья	Orsogna
онака,франция,коммуна,Онак	Aunac
о-ньонг,камерун,департамент,О-Ньонг 	Haut-Nyong
оха,россия,город,Оха	Okha,_Russia
опочецкий район,россия,Опочецкий район	Opochetsky_District
олье-д’агуа,бразилия,параиб,Олью-д’Агуа 	Olho_d'Água
одобешть,румыния,город,Одобешти	Odobești
ольсдорф,германия,айфель,коммуна,Ольсдорф 	Olsdorf
ольнуа-ле-валансьен,франция,коммуна,Ольнуа-ле-Валансьен	Aulnoy-lez-Valenciennes
оберхармерсбах,германия,коммуна,Оберхармерсбах	Oberharmersbach
онешть,румыния,город,Онешти	Onești
опава,чехия,район,Опава 	Opava_District
орнон,франция,коммуна,Орнон	Ornon
оржа,франция,коммуна,Орже 	Orgeix
осдорф,германия,коммуна,Осдорф	Osdorf,_Schleswig-Holstein
османвиль,франция,коммуна,Османвиль	Osmanville
оакс-эстейт,австралия,деревня,Оакс-Эстейт	Oaks_Estate,_Australian_Capital_Territory
оутапать,намибия,Оутапи	Outapi
офланс,франция,коммуна,Офланс	Auflance
остерод-ама-харц,германия,город,Остероде-ам-Харц	Osterode_am_Harz
обинья-ан-артуа,франция,коммуна,Обиньи-ан-Артуа	Aubigny-en-Artois
орто,франция,коммуна,Орто 	Orto
оберзульм,германия,посёлок,Оберзульм	Obersulm
о-клэр,соединять штат америка,висконсин,город,О-Клэр 	Eau_Claire,_Wisconsin
ойсенхайм,германия,коммуна,Ойсенхайм	Eußenheim
орайон,соединять штат америка,тауншип,миннесота,Орайон 	Orion_Township,_Olmsted_County,_Minnesota
остин,соединять штат америка,город,техас,Остин 	Austin,_Texas
оффенбах-ан-дер-квайх,германия,коммуна,Оффенбах-ан-дер-Квайх	Offenbach_an_der_Queich
орег,франция,коммуна,Орег	Orègue
октябрьский,россия,посёлок,октябрьский район,пермский край,Октябрьский 	Oktyabrsky,_Oktyabrsky_District,_Perm_Krai
окаванго,намибия,намибия,город,Окаванго 	Kavango_Region
одесский экзархат угкца,украина,Одесский экзархат УГКЦ	Ukrainian_Catholic_Archiepiscopal_Exarchate_of_Odessa
ольдзума,германия,коммуна,Ольдзум	Oldsum
омск,россия,Омск	Omsk
омекур,франция,коммуна,Омекур	Homécourt
остров циглер,россия,Остров Циглера	Ziegler_Island
оризон,бразилия,муниципалитет,парана,Оризона 	Ourizona
одай,япония,посёлок,Одай	Ōdai,_Mie
обервольф,германия,коммуна,Обервольфах	Oberwolfach
оберхаузен-райнхаузен,германия,коммуна,Оберхаузен-Райнхаузен	Oberhausen-Rheinhausen
остров фуругельм,россия,остров,Остров Фуругельма	Furugelm_Island
оконто,соединять штат америка,висконсин,город,Оконто 	Oconto,_Wisconsin
ос-и-костеан,испания,муниципалитет,Ос-и-Костеан	Hoz_y_Costean
оберхарц-ама-броккен,германия,Оберхарц-ам-Броккен	Oberharz_am_Brocken
олива-де-мерида,испания,муниципалитет,Олива-де-Мерида	Oliva_de_Mérida
облученский район,россия,Облученский район	Obluchensky_District
обривать-сюр-варез,франция,коммуна,Обрив-сюр-Варез	Auberives-sur-Varèze
обь,франция,округ дуэ,коммуна,Оби 	Auby
ож-сено-медар,франция,коммуна,Ож-Сен-Медар	Auge-Saint-Médard
оберрит,швейцария,община,санкт-галлен,Оберрит 	Oberriet
обернфельд,германия,коммуна,Обернфельд	Obernfeld
обердорф,швейцария,нидвальден,коммуна,Обердорф 	Oberdorf,_Nidwalden
одрессный,франция,коммуна,Одрессен	Audressein
остерволе,германия,коммуна,Остерволе	Osterwohle
окаяма,япония,префектура,город,Окаяма 	Okayama_Prefecture
ольховка,россия,село,волгоградский область,Ольховка 	Olkhovka,_Volgograd_Oblast
орнет,польша,город,Орнета	Orneta
освенцимский повенок,польша,город,Освенцимский повят	Oświęcim_County
островский район,россия,посёлок,костромской область,Островский район 	Ostrovsky_District,_Kostroma_Oblast
омбур-от,франция,коммуна,Омбур-От	Hombourg-Haut
остин,соединять штат америка,арканзас,Остин 	Austin,_Arkansas
одервиц,германия,коммуна,Одервиц	Oderwitz
овин,франция,коммуна,Овине	Hauviné
орес,испания,муниципалитет,Орес	Orés
остхайм-фора-дер-рен,германия,город,Остхайм-фор-дер-Рён	Ostheim
обтирать,франция,об,коммуна,Обтер 	Aubeterre
отр-ле-ве,франция,коммуна,Отре-ле-Ве	Autrey-le-Vay
орсениго,италия,коммуна,Орсениго	Orsenigo,_Lombardy
омутнинский район,россия,Омутнинский район	Omutninsky_District
отвенный,франция,коммуна,Отвен	Hautevesnes
оберланген,германия,коммуна,Оберланген	Oberlangen
охар,япония,посёлок,Охару	Ōharu,_Aichi
онея,мексика,Оней	Honey_(municipality)
оберлайхтерсбах,германия,коммуна,Оберлайхтерсбах	Oberleichtersbach
ортелл,италия,коммуна,Ортелле	Ortelle
оберлаух,германия,коммуна,Оберлаух	Oberlauch
ольт,франция,населенный пункт,сомма,Ольт 	Ault,_Somme
отопень,румыния,город,Отопень	Otopeni
одинья,франция,коммуна,Одиньи	Audigny
олбануть,соединять штат америка,город,миннесота,Олбани 	Albany,_Minnesota
ои,франция,коммуна,Ои	Ohis
оппертсхаузен,германия,коммуна,Оппертсхаузен	Oppertshausen
отеро-де-эррерасти,испания,Отеро-де-Эррерос	Otero_de_Herreros
одюбон,соединять штат америка,нью-джерси,город,Одюбон 	Audubon,_New_Jersey
оберкайль,германия,коммуна,Оберкайль	Oberkail
онжон,франция,коммуна,Онжон	Onjon
остин,соединять штат америка,город,миннесота,Остин 	Austin,_Minnesota
обинья-о-кен,франция,коммуна,Обиньи-о-Кен	Aubigny-aux-Kaisnes
одрейн,соединять штат америка,округ,миссури,Одрейн 	Audrain_County,_Missouri
озидда,италия,коммуна,Озидда	Osidda
ормуаш,франция,коммуна,Ормуаш	Ormoiche
обинья-ле-сомбернон,франция,коммуна,Обиньи-ле-Сомбернон	Aubigny-lès-Sombernon
олевский район,украина,Олевский район	Olevsk_Raion
оден-ле-роман,франция,коммуна,Одён-ле-Роман	Audun-le-Roman
ондзюк,япония,посёлок,Ондзюку	Onjuku
остштайнбек,германия,коммуна,Остштайнбек	Oststeinbek
овандо,республика конго,город,Овандо	Owando
орный,италия,коммуна,Орнаго	Ornago
отревиль,франция,коммуна,эна,Отревиль 	Autreville,_Aisne
оттерталь,австрия,коммуна,Оттерталь	Otterthal
ошикото,намибия,город,Ошикото	Oshikoto_Region
озаско,италия,коммуна,Озаско	Osasco,_Piedmont
оппенау,германия,город,Оппенау	Oppenau
оло,франция,коммуна,Оло	Aulos,_Ariège
орен,франция,коммуна,атлантический пиренеи,Орен 	Orin,_Pyrénées-Atlantiques
оберплайхфельд,германия,коммуна,Оберплайхфельд	Oberpleichfeld
озерск,россия,челябинский область,город,Озёрск 	Ozyorsk,_Chelyabinsk_Oblast
оксенхоуп,великобритания,деревня,Оксенхоуп	Oxenhope
обермихельба,германия,коммуна,Обермихельбах	Obermichelbach
орьокур,франция,коммуна,Орьокур	Oriocourt
оромия,эфиопия,Оромия	Oromia_Region
отроша,франция,коммуна,Отрош	Hauteroche
обераудорф,германия,коммуна,Обераудорф	Oberaudorf
обертауфкирхен,германия,коммуна,Обертауфкирхен	Obertaufkirchen
ортуэлья,испания,Ортуэлья	Ortuella
одинцово,россия,город,Одинцово	Odintsovo
оцелул-рош,румыния,город,Оцелул-Рошу	Oțelu_Roșu
обижать,болгария,село,Обидим	Obidim
осуиго,соединять штат америка,нью-йорк,округ,Осуиго 	Oswego_County,_New_York
оффенберг,германия,коммуна,Оффенберг	Offenberg
олужас,испания,Олужас	Les_Oluges
ормигос,испания,Ормигос	Hormigos
обань,франция,город,Обань	Aubagne
орье,франция,коммуна,Орья 	Auriat
оберланд-ама-ренштайг,германия,коммуна,Оберланд-ам-Ренштайг	Oberland_am_Rennsteig
омоль,швеция,город,Омоль 	Åmål
ормуа,франция,верхний сона,коммуна,Ормуа 	Ormoy,_Haute-Saône
оберрютя,швейцария,коммуна,Оберрюти	Oberrüti
оберштекхольц,швейцария,коммуна,Оберштекхольц	Obersteckholz
оравски подзамок,словакия,деревня,район долна кубин,Оравски Подзамок 	Oravský_Podzámok
окадзаки,япония,Окадзаки	Okazaki,_Aichi
онтигол,испания,Онтигола	Ontígola
оньят,испания,муниципалитет,Оньяте	Oñati
оттенсхайм,австрия,Оттенсхайм	Ottensheim
оборницкий повенок,польша,город,Оборницкий повят	Oborniki_County
остенде,бельгия,Остенде	Ostend
орезон,франция,коммуна,Орезон	Oraison
онвервахта,суринам,город,Онвервахт	Onverwacht,_Suriname
отвьель-сено-мартен-бидеран,франция,коммуна,Отвьель-Сен-Мартен-Бидеран	Autevielle-Saint-Martin-Bideren
овен,германия,город,Овен 	Owen,_Germany
опово,сербия,город,Опово 	Opovo
оршанский район,россия,посёлок,марья эл,Оршанский район 	Orshansky_District
остербург,германия,альтмарк,город,Остербург 	Osterburg_(Altmark)
олстер,соединять штат америка,нью-йорк,округ,Олстер 	Ulster_County,_New_York
оденбах,германия,коммуна,город,Оденбах 	Odenbach
оницкан,молдавия,село,Оницканы	Onițcani
овчарово,болгария,село,хасковский область,Овчарово 	Ovcharovo,_Haskovo_Province
ольмедильо-де-роа,испания,Ольмедильо-де-Роа	Olmedillo_de_Roa
остров возрождение,узбекистан,Остров Возрождения	Vozrozhdeniya_Island
орбанех-риопико,испания,Орбанеха-Риопико	Orbaneja_Riopico
ойрасбург,германия,швабия,коммуна,Ойрасбург 	Eurasburg,_Swabia
ореш,болгария,село,Ореше	Oreshe
оттенштайн,германия,коммуна,нижний саксония,Оттенштайн 	Ottenstein
оккьеппо-супериора,италия,коммуна,Оккьеппо-Супериоре	Occhieppo_Superiore
орей,франция,коммуна,Орей	Aureille
остыр-камык,болгария,село,Остыр-Камык	Ostar_kamak
оснабрюк,германия,район,Оснабрюк 	Osnabrück_(district)
оберфогау,австрия,коммуна,Оберфогау	Obervogau
округ 02,германия,дюссельдорф,Округ 02 	District_2,_Düsseldorf
ороко,бразилия,муниципалитет,Ороко	Orocó
обонкур-возель,франция,коммуна,Обонкур-Возель	Auboncourt-Vauzelles
октябрьский район,россия,ростовский область,Октябрьский район 	Oktyabrsky_District,_Rostov_Oblast
орловский район,россия,орловский область,Орловский район 	Orlovsky_District,_Oryol_Oblast
осинский район,россия,село,иркутский область,Осинский район 	Osinsky_District,_Irkutsk_Oblast
ольмед-де-ласа-фуэнтес,испания,муниципалитет,Ольмеда-де-лас-Фуэнтес	Olmeda_de_las_Fuentes
ораньемунд,намибия,город,Ораньемунд	Oranjemund
онтанас,испания,Онтанас	Hontanas
остермундиген,швейцария,коммуна,Остермундиген	Ostermundigen
оксенфурт,германия,город,Оксенфурт	Ochsenfurt
октябрьский район,россия,курская область,Октябрьский район 	Oktyabrsky_District,_Kursk_Oblast
ориоло,италия,коммуна,Ориоло	Oriolo
очимбингве,намибия,населённый пункт,Очимбингве	Otjimbingwe
оберфишбах,германия,коммуна,Оберфишбах	Oberfischbach
оленек,россия,село,Оленёк 	Olenyok_(rural_locality)
ористать,италия,коммуна,Ористано	Oristano
окилтри,соединять штат америка,округ,техас,Окилтри 	Ochiltree_County,_Texas
оберлунгвиц,германия,город,Оберлунгвиц	Oberlungwitz
окоп,украина,тернопольский область,Окопы 	Okopy,_Ternopil_Oblast
осбург,германия,коммуна,Осбург	Osburg
отави,намибия,Отави	Otavi
озерайя,франция,коммуна,Озерай	Ozerailles
орьяк-л’эглиз,франция,коммуна,Орьяк-л’Эглиз	Auriac-l'Église
окленд,соединять штат америка,калифорния,Окленд 	Oakland,_California
овчар,польша,краковский повенок,село,Овчары 	Owczary,_Kraków_County
обо,центральноафриканский республика,столица,город,Обо 	Obo
орум,германия,коммуна,Орум	Ohrum
орье,франция,коммуна,Орьё	Orieux
орьяк-лагаста,франция,коммуна,Орьяк-Лагаст	Auriac-Lagast
оттерфинг,германия,коммуна,Оттерфинг	Otterfing
оливелья,испания,муниципалитет,Оливелья	Olivella
остингерслебен,германия,деревня,Остингерслебен	Ostingersleben
остров райнер,россия,остров,Остров Райнера	Rainer_Island
оглиторп,соединять штат америка,округ,джорджия,Оглиторп 	Oglethorpe_County,_Georgia
орисса,индия,штат,Орисса	Odisha
окуловский район,россия,город,Окуловский район	Okulovsky_District
острогожск,россия,город,Острогожск	Ostrogozhsk
ольп,германия,район,Ольпе 	Olpe_(district)
ояпока,бразилия,муниципалитет,Ояпоки	Oiapoque
оливейра,португалия,район,барселуша,Оливейра 	Oliveira_(Barcelos)
онцо,италия,коммуна,Онцо	Onzo
оленекский район,россия,село,Оленёкский район	Olenyoksky_District
омский район,россия,посёлок,Омский район	Omsky_District
оспедалетти,италия,коммуна,Оспедалетти	Ospedaletti
обервизенталь,германия,город,Обервизенталь	Oberwiesenthal
ораделла,соединять штат америка,нью-джерси,Ораделл 	Oradell,_New_Jersey
о-сассандра,кот-д’ивуар,город,О-Сассандра	Haut-Sassandra
ольм,франция,коммуна,Ольме	Haulmé
оберлангенег,швейцария,коммуна,Оберлангенег	Oberlangenegg
оберхофен-ама-иррзой,австрия,коммуна,Оберхофен-ам-Иррзее	Oberhofen_am_Irrsee
о,норвегия,деревня,москенес,О 	Å,_Moskenes
оссаки,франция,коммуна,Оссак	Aussac
обербеттинген,германия,коммуна,Обербеттинген	Oberbettingen
оберн,соединять штат америка,калифорния,город,Оберн 	Auburn,_California
оконешниковский район,россия,Оконешниковский район	Okoneshnikovsky_District
ольденбург-ин-хольштайн,германия,город,Ольденбург-ин-Хольштайн	Oldenburg_in_Holstein
октябрьский район,россия,ханты-мансийский автономный округ,Октябрьский район 	Oktyabrsky_District,_Khanty-Mansi_Autonomous_Okrug
оклахома,соединять штат америка,штат,Оклахома	Oklahoma
обервег,австрия,коммуна,Обервег	Oberweg
ошенкерн,великобритания,Ошенкерн	Auchencairn
овайхи,соединять штат америка,округ,айдахо,Овайхи 	Owyhee_County,_Idaho
олецкий,польша,гмина,Олецко 	Gmina_Olecko
оттензос,германия,коммуна,Оттензос	Ottensoos
османель,турция,город,Османели	Osmaneli
ольджат-олон,италия,город,Ольджате-Олона	Olgiate_Olona
обермайтинген,германия,коммуна,Обермайтинген	Obermeitingen
оти,франция,кальвадос,коммуна,Оти 	Authie,_Calvados
ове-э-ла-шаплот,франция,коммуна,Ове-э-ла-Шаплот	Auvet-et-la-Chapelotte
обрубать,чехия,община,Обруби	Obruby
отань,сербия,Отань	Otanj
обфельден,швейцария,коммуна,Обфельден	Obfelden
озас,франция,коммуна,Озас	Auzas
оттеншлаг,австрия,нижний австрия,Оттеншлаг 	Ottenschlag
отвайлер,германия,город,Отвайлер	Ottweiler
огат,япония,село,Огата	Ōgata,_Akita
озинский район,россия,Озинский район	Ozinsky_District
онтория-де-серрато,испания,населённый пункт,Онтория-де-Серрато	Hontoria_de_Cerrato
ош-ле-мина,франция,коммуна,Оши-ле-Мин	Auchy-les-Mines
орсар-ди-пул,италия,коммуна,Орсара-ди-Пулья	Orsara_di_Puglia
осиный,япония,село,Осино	Oshino,_Yamanashi
обершикур,франция,коммуна,Обершикур	Auberchicourt
обервайсбах,германия,тюрингенский лес,город,Обервайсбах 	Oberweißbach
облазница,украина,село,Облазница	Oblaznytsia
одесса,соединять штат америка,город,миннесота,Одесса 	Odessa,_Minnesota
оссиах,австрия,коммуна,Оссиах	Ossiach
ориваль,франция,шарант,коммуна,Ориваль 	Orival,_Charente
ореховый-борисово южный,россия,Орехово-Борисово Южное	Orekhovo-Borisovo_Yuzhnoye_District
оамар,новый зеландия,Оамару	Oamaru
орша,россия,посёлок,тверская область,поселок городской тип,Орша 	Orsha_(urban-type_settlement),_Tver_Oblast
отвель,франция,коммуна,Отвель 	Hautevelle
обрекать,франция,коммуна,Обрек	Obreck
обертифенбах,германия,таунус,коммуна,Обертифенбах 	Obertiefenbach
островский район,россия,костромской область,Островский район 	Ostrovsky_District,_Kostroma_Oblast
оппидо-мамертина,италия,коммуна,Оппидо-Мамертина	Oppido_Mamertina
ольденсворт,германия,коммуна,Ольденсворт	Oldenswort
осс,нидерланды,город,Осс	Oss
окар,бразилия,сеара,Окара 	Ocara
орино,италия,коммуна,Орино	Orino,_Lombardy
ореховский район,украина,город,Ореховский район	Orikhiv_Raion
орийака,франция,город,Орийак	Aurillac
ординский район,россия,село,Ординский район	Ordinsky_District
оливейра,бразилия,минас-жерайс,Оливейра 	Oliveira,_Minas_Gerais
обербергкирхен,германия,коммуна,Обербергкирхен	Oberbergkirchen
октябрьский район,россия,посёлок,курская область,Октябрьский район 	Oktyabrsky_District,_Kursk_Oblast
остерби,германия,шлезвиг-фленсбург,коммуна,Остерби 	Osterby,_Schleswig-Flensburg
оберельберт,германия,коммуна,Оберельберт	Oberelbert
оломоуц,чехия,район,Оломоуц 	Olomouc_District
огузханский этрап,туркмения,Огузханский этрап	Oguzhan_District
омисси,франция,коммуна,Омисси	Omissy
одос,франция,коммуна,Одос	Odos
озини,италия,коммуна,Озини	Osini
ози,франция,коммуна,Ози	Auzits
ограждать,болгария,село,Огражден 	Ograzhden,_Dobrich_Province
онрубий-де-ла-куэст,испания,Онрубия-де-ла-Куэста	Honrubia_de_la_Cuesta
ольбий,италия,город,Ольбия	Olbia
орг,франция,коммуна,Орг	Horgues
озалп,турция,город,Озалп	Özalp,_Van
ордонный,франция,коммуна,Ордонна	Ordonnaz
окдейл,соединять штат америка,город,миннесота,Окдейл 	Oakdale,_Minnesota
обермелер,германия,коммуна,Обермелер	Obermehler
обершайнфельд,германия,коммуна,Обершайнфельд	Oberscheinfeld
ожарув-мазовецкий,польша,Ожарув-Мазовецкий	Ożarów_Mazowiecki
осекать,чехия,город,чехия,Осек 	Osek_(Teplice_District)
овариасаха,япония,город,Овариасахи	Owariasahi,_Aichi
орать,бразилия,санта-катарина,Ору 	Ouro
ольвег,испания,Ольвега	Ólvega
ортийон,франция,коммуна,Ортийон	Ortillon
оберотмарсхаузен,германия,коммуна,Оберотмарсхаузен	Oberottmarshausen
оберкирн,германия,коммуна,Оберкирн	Oberkirn
овернь,франция,Овернь	Auvergne_(region)
отрадненский район,россия,Отрадненский район	Otradnensky_District
орждь,франция,коммуна,Орждёй	Orgedeuil
отака,япония,поселок,посёлок,Отаки 	Ōtaki,_Chiba
олбануть,соединять штат америка,город,техас,Олбани 	Albany,_Texas
оходза,польша,село,малопольский воеводство,Оходза 	Ochodza,_Lesser_Poland_Voivodeship
оболонский район,украина,Оболонский район	Obolonskyi_District
онскирша,франция,коммуна,Онскирш	Honskirch
октябрьский район,россия,костромской область,Октябрьский район 	Oktyabrsky_District,_Kostroma_Oblast
оберзиггенталь,швейцария,коммуна,Оберзиггенталь	Obersiggenthal
ольмо-джентиль,италия,коммуна,Ольмо-Джентиле	Olmo_Gentile
ор,италия,провинция больцано,коммуна,Ора 	Auer,_South_Tyrol
окосинго,мексика,город,Окосинго	Ocosingo
оратино,италия,Оратино	Oratino
остерфельд,германия,саксония-анхальт,город,Остерфельд 	Osterfeld
ораас,франция,коммуна,Ораас	Oraàs
олльный,франция,коммуна,южный корсик,Оллен 	Aullène
ойос,испания,муниципалитет,Ойос	Hoyos
оберхаллау,швейцария,коммуна,Оберхаллау	Oberhallau
оден,испания,муниципалитет,льейд,Оден 	Odèn
ожиш,польша,город,Ожиш	Orzysz
ортез,франция,город,Ортез	Orthez
ортиньяно-раджоло,италия,коммуна,Ортиньяно-Раджоло	Ortignano_Raggiolo
отсего,соединять штат америка,нью-йорк,округ,Отсего 	Otsego_County,_New_York
обердорфф,франция,коммуна,Обердорфф	Oberdorff
олонецкий район,россия,город,Олонецкий район	Olonetsky_District
олетта,франция,коммуна,Олетта	Oletta
орбетелло,италия,город,Орбетелло	Orbetello
оборник-сленск,польша,гмина,Оборники-Слёнске 	Gmina_Oborniki_Śląskie
окхольм,германия,коммуна,Окхольм	Ockholm
омит,ирландия,деревня,Омит	Omeath
обанадзав,япония,город,Обанадзава	Obanazawa,_Yamagata
обердрайс,германия,коммуна,Обердрайс	Oberdreis
обровац,босния и герцеговина,село,республика сербский,Обровац 	Obrovac,_Banja_Luka
омикур,франция,коммуна,Омикур	Omicourt
овчарово,болгария,добричский область,село,Овчарово 	Ovcharovo,_Dobrich_Province
оберстдорф,германия,коммуна,Оберстдорф	Oberstdorf
олешица,польша,Олешице	Oleszyce
орать-вель,бразилия,муниципалитет,Ору-Велью	Ouro_Velho
октябрьский район,россия,оренбургский область,Октябрьский район 	Oktyabrsky_District,_Orenburg_Oblast
опочка,россия,город,Опочка	Opochka
орьоль,франция,коммуна,буш-дю-рон,Орьоль 	Auriol,_Bouches-du-Rhône
одоло,италия,коммуна,Одоло	Odolo
охинлек,великобритания,город,Охинлек	Auchinleck
озерский городской округ,россия,калининградский область,Озёрский городской округ 	Ozyorsky_District,_Kaliningrad_Oblast
окамвиль,франция,коммуна,верхний гаронна,Окамвиль 	Aucamville,_Haute-Garonne
ольшовица,польша,село,Ольшовице	Olszowice
обрубец,чехия,община,Обрубце	Obrubce
осуюс,канада,община,Осуюс 	Osoyoos
орешец,болгария,село,хасковский область,Орешец 	Oreshets,_Haskovo_Province
оджоно,италия,населённый пункт,Оджоно	Oggiono
осмаци,босния и герцеговина,населённый пункт,Осмаци	Osmaci
оцьери,италия,коммуна,Оцьери	Ozieri
одерауэ,германия,коммуна,Одерауэ	Oderaue
орио-аль-серио,италия,коммуна,Орио-аль-Серио	Orio_al_Serio
оливедус,бразилия,Оливедус	Olivedos,_Paraíba
оно-сан-пьетро,италия,коммуна,Оно-Сан-Пьетро	Ono_San_Pietro
отон-эбеон,франция,коммуна,Отон-Эбеон	Authon-Ébéon
одиньикур,франция,коммуна,Одиньикур	Audignicourt
ола,соединять штат америка,арканзас,Ола 	Ola,_Arkansas
ом,япония,япония,посёлок,Ома 	Ōma,_Aomori
остшешув,польша,Остшешув	Ostrzeszów
олур,турция,город,Олур	Olur
ор-эркеншвик,германия,город,Ор-Эркеншвик	Oer-Erkenschwick
омельмон,франция,коммуна,Омельмон	Omelmont
очиваронго,намибия,город,Очиваронго	Otjiwarongo
овиллар,франция,коммуна,Овиллар	Auvillars
одатэ,япония,город,Одатэ	Ōdate
обербаххайм,германия,коммуна,Обербаххайм	Oberbachheim
оберхайд,германия,коммуна,вестервальд,Оберхайд 	Oberhaid,_Rhineland-Palatinate
орпунд,швейцария,коммуна,Орпунд	Orpund
оссио,соединять штат америка,город,миннесота,Оссио 	Osseo,_Minnesota
оттенбюттель,германия,коммуна,Оттенбюттель	Ottenbüttel
ополе,польша,город,Ополе	Opole
одесса,соединять штат америка,город,техас,Одесса 	Odessa,_Texas
орикур,франция,коммуна,Орикур	Oricourt
ошакатить,намибия,город,Ошакати	Oshakati
олонец,россия,город,Олонец	Olonets
ораньестад,аруба,аруба,Ораньестад 	Oranjestad,_Aruba
орьяк,франция,коррез,коммуна,Орьяк 	Auriac,_Corrèze
огден,соединять штат америка,юта,город,Огден 	Ogden,_Utah
ольяна,португалия,район,Ольян 	Olhão_(parish)
оссинген,швейцария,коммуна,Оссинген	Ossingen
обичник,болгария,село,Обичник	Obichnik
обервиль,франция,коммуна,Обервиль	Auberville
оренбург,россия,город,Оренбург	Orenburg
орельян-ла-вьех,испания,Орельяна-ла-Вьеха	Orellana_la_Vieja
оберенц,швейцария,коммуна,Оберёнц	Oberönz
отвиль,франция,коммуна,эна,Отвиль 	Hauteville,_Aisne
олинда-новый-ду-мараньян,бразилия,Олинда-Нова-ду-Мараньян	Olinda_Nova_do_Maranhão
ольтр-иль-колл,италия,коммуна,Ольтре-иль-Колле	Oltre_il_Colle
опатия,хорватия,город,Опатия	Opatija
оберкотцау,германия,коммуна,Оберкотцау	Oberkotzau
охихарес,испания,муниципалитет,Охихарес	Ogíjares
оконджа,габон,город,Оконджа	Okondja
офтерсхайм,германия,коммуна,Офтерсхайм	Oftersheim
оминьяно,италия,коммуна,Оминьяно	Omignano
орать-верди,бразилия,муниципалитет,санта-катарина,Ору-Верди 	Ouro_Verde,_Santa_Catarina
оте,франция,коммуна,Оте	Autet
орчха,индия,город,Орчха	Orchha
обать,камерун,город,Обала	Obala
овюрский кожуун,россия,село,Овюрский кожуун	Ovyursky_District
ош,франция,коммуна,арденны,Ош 	Oches
орансан,франция,верхний пиренеи,коммуна,Орансан 	Aurensan,_Hautes-Pyrénées
они-сюр-одон,франция,коммуна,Оне-сюр-Одон	Aunay-sur-Odon
оссетт,великобритания,город,Оссетт	Ossett
оем,габон,город,Оем	Oyem
оцук,япония,город,Оцуки 	Ōtsuki,_Yamanashi
обуаси,ган,город,Обуаси	Obuasi
озерный,россия,посёлок,тверская область,Озёрный 	Ozyorny,_Tver_Oblast
ореа,испания,Ореа	Orea
оттерсхайм-ландау,германия,коммуна,Оттерсхайм-Ландау	Ottersheim_bei_Landau
оберембр,швейцария,коммуна,Оберембрах	Oberembrach
онагава,япония,посёлок,Онагава	Onagawa,_Miyagi
ошский область,киргизия,город,Ошская область	Osh_Region
орвийер-сено-жюльен,франция,коммуна,Орвийер-Сен-Жюльен	Orvilliers-Saint-Julien
оламбра,бразилия,Оламбра	Holambra
озило,италия,коммуна,Озило	Osilo
оккьобелло,италия,коммуна,Оккьобелло	Occhiobello
озерский городской округ,россия,калининградский область,город,Озёрский городской округ 	Ozyorsky_District,_Kaliningrad_Oblast
оберройт,германия,коммуна,Оберройте	Oberreute
ольн,бельгия,коммуна,Ольн	Olne
ольмед-де-кобет,испания,Ольмеда-де-Кобета	Olmeda_de_Cobeta
оля,россия,астраханский область,Оля 	Olya
оливери,италия,коммуна,Оливери	Oliveri
обергесген,швейцария,коммуна,Обергёсген	Obergösgen
октябрьский район,россия,челябинский область,село,Октябрьский район 	Oktyabrsky_District,_Chelyabinsk_Oblast
овас,япония,город,Овасе	Owase,_Mie
онеймия,соединять штат америка,город,миннесота,Онеймия 	Onamia,_Minnesota
орен,франция,коммуна,верхний гаронна,Орен 	Aurin,_Haute-Garonne
отлукбель,турция,город,Отлукбели	Otlukbeli
оджеббио,италия,коммуна,Оджеббио	Oggebbio
отр,франция,мерт  мозель,коммуна,Отре 	Autrey,_Meurthe-et-Moselle
офунато,япония,город,Офунато	Ōfunato
омитар,намибия,Омитара	Omitara
ореховый-борисово южный,россия,район,Орехово-Борисово Южное	Orekhovo-Borisovo_Yuzhnoye_District
орриус,испания,населённый пункт,Орриус	Òrrius
олеак-деся,франция,коммуна,Олеак-Десю	Oléac-Dessus
ольштынька,польша,гмина,Ольштынек 	Gmina_Olsztynek
олькань,франция,коммуна,Олькани	Olcani
обуховский район,украина,город,Обуховский район	Obukhiv_Raion
обербецберг,швейцария,коммуна,Обербёцберг	Oberbözberg
орьебат,франция,коммуна,Орьебат	Auriébat
ольштынька,польша,город,Ольштынек	Olsztynek
он,италия,коммуна,валль-д’аоста,Он 	Hône
охос-альбос,испания,Охос-Альбос	Ojos-Albos
ордынский район,россия,посёлок,Ордынский район	Ordynsky_District
отеррив,франция,коммуна,Отеррив	Auterrive
оберрамзерн,швейцария,коммуна,Оберрамзерн	Oberramsern
ольберслебен,германия,коммуна,Ольберслебен	Olbersleben
оногур,болгария,село,Оногур	Onogur,_Bulgaria
оспедалетто,италия,коммуна,Оспедалетто	Ospedaletto,_Trentino
остерхольц-шармбек,германия,город,Остерхольц-Шармбек	Osterholz-Scharmbeck
оберштедь,германия,коммуна,Оберштедем	Oberstedem
оренбах,германия,коммуна,Оренбах	Ohrenbach
освьель,франция,коммуна,Освьель	Aussevielle
обозерский,россия,посёлок,Обозерский	Obozersky
оландон,франция,коммуна,Оландон	Olendon
орио-канавез,италия,коммуна,Орио-Канавезе	Orio_Canavese
оливади,италия,коммуна,Оливади	Olivadi
оберпуллендорф,австрия,город,Оберпуллендорф	Oberpullendorf
опаринский район,россия,посёлок,Опаринский район	Oparinsky_District
озориу,бразилия,муниципалитет,риу-гранди-ду-сул,Озориу 	Osório,_Rio_Grande_do_Sul
осташковский район,россия,Осташковский район	Ostashkovsky_District
осорный,чили,провинция,Осорно 	Osorno_Province
оттава,канада,квебек,регион,Оттава 	Outaouais
область саванна,то,город,Область Саванн	Savanes_Region,_Togo
оук-гров,соединять штат америка,округ карролл,арканзас,Оук-Гров 	Oak_Grove,_Carroll_County,_Arkansas
одюбон,соединять штат америка,округ,айова,Одюбон 	Audubon_County,_Iowa
отон,франция,альпы верхний прованс,коммуна,Отон 	Authon,_Alpes-de-Haute-Provence
огняново,болгария,добричский область,село,Огняново 	Ognyanovo,_Dobrich_Province
ордруф,германия,Ордруф	Ohrdruf
оренбургский область,россия,город,Оренбургская область	Orenburg_Oblast
омсталь,швейцария,коммуна,Омсталь	Ohmstal
онь,франция,коммуна,эна,Онь 	Ognes,_Aisne
оберштра,германия,коммуна,Оберштрой	Oberstreu
они,франция,приморский шарант,коммуна,Оне 	Aulnay,_Charente-Maritime
осака,япония,префектура,город,Осака 	Osaka_Prefecture
оберхайд,германия,коммуна,верхний франкония,Оберхайд 	Oberhaid
обидус,бразилия,пара,город,Обидус 	Óbidos,_Pará
осиецкий-бараньский жупание,хорватия,город,Осиецко-Бараньская жупания	Osijek-Baranja_County
оссан,италия,коммуна,Оссана	Ossana
осорнильо,испания,населённый пункт,Осорнильо	Osornillo
оберальм,австрия,Оберальм	Oberalm
ользь,франция,франция,коммуна,Ользи 	Ollezy
обаред,франция,коммуна,Обаред	Aubarède
овар,франция,франция,коммуна,Овар 	Auvare
оркойен,испания,Оркойен	Orcoyen
обри,соединять штат америка,арканзас,Обри 	Aubrey,_Arkansas
оберентфельден,швейцария,коммуна,Оберентфельден	Oberentfelden
оренса,испания,Оренсе	Ourense
обероттербах,германия,коммуна,Обероттербах	Oberotterbach
огненный,аргентина,южный, ,антарктида,остров,атлантика,и,
,город,земля,Огненная Земля	Tierra_del_Fuego_Province,_Argentina
озимый,италия,коммуна,Озимо	Osimo
остров артур,россия,остров,Остров Артура	Arthur_Island
обернцелль,германия,коммуна,Обернцелль	Obernzell
оконто,соединять штат америка,округ,Оконто 	Oconto_County,_Wisconsin
орбассано,италия,коммуна,Орбассано	Orbassano
осатый,япония,поселок,посёлок,Осато 	Ōsato,_Miyagi
осорный-ла-майор,испания,Осорно-ла-Майор	Osorno_la_Mayor
ота,япония,япония,город,Ота 	Ōta,_Gunma
осина,болгария,болгария,село,Осина 	Osina,_Blagoevgrad_Province
обергуриг,германия,коммуна,Обергуриг	Obergurig
острудский повенок,польша,город,Острудский повят	Ostróda_County
одибон,соединять штат америка,город,миннесота,Одибон 	Audubon,_Minnesota
он,франция,коммуна,ода,Он 	Homps,_Aude
опичный,мексика,муниципалитет,Опичен 	Opichén_Municipality
оушен,соединять штат америка,округ,нью-джерси,Оушен 	Ocean_County,_New_Jersey
олинтла,мексика,муниципалитет,Олинтла	Olintla
орлекс,франция,коммуна,Орлекс	Orleix
омекс,франция,коммуна,Омекс	Omex
ойос-дель-кольядо,испания,Ойос-дель-Кольядо	Hoyos_del_Collado
орэштие,румыния,город,Орэштие	Orăștie
оттава,канада,столица,Оттава	Ottawa
острувский повенок,польша,великопольский воеводство,город,Острувский повят 	Ostrów_Wielkopolski_County
обершлайсхайм,германия,коммуна,Обершлайсхайм	Oberschleißheim
ослинг,германия,коммуна,Ослинг	Oßling
отнанг-на-хаусрук,австрия,коммуна,Отнанг-на-Хаусруке	Ottnang_am_Hausruck
оконкур,франция,коммуна,Оконкур	Hauconcourt
ольджат-комаско,италия,город,Ольджате-Комаско	Olgiate_Comasco
ольмо,франция,коммуна,Ольмо	Olmo,_Haute-Corse
олула-дель-рио,испания,населённый пункт,Олула-дель-Рио	Olula_del_Río
онуа-эмери,франция,коммуна,Онуа-Эмери	Aulnoye-Aymeries
ориньяк,франция,верхний пиренеи,коммуна,Ориньяк 	Orignac
омиш,хорватия,город,Омиш	Omiš
ойсерталь,германия,коммуна,Ойсерталь	Eußerthal
октябрьский район,россия,посёлок,волгоградский область,Октябрьский район 	Oktyabrsky_District,_Volgograd_Oblast
оберкурцхайм,австрия,коммуна,Оберкурцхайм	Oberkurzheim
олдем,великобритания,Олдем	Oldham
оссонвиль,франция,коммуна,Оссонвиль	Haussonville
оф,турция,город,Оф	Of,_Turkey
орявый,украина,село,Орява 	Oriava
омесса,франция,коммуна,Омесса	Omessa
ояма,япония,город,Ояма 	Oyama,_Tochigi
окинава,япония,префектура,город,Окинава 	Okinawa_Prefecture
обердакштеттен,германия,коммуна,Обердакштеттен	Oberdachstetten
ойтинген-они-гой,германия,коммуна,Ойтинген-им-Гой	Eutingen_im_Gäu
орис,испания,муниципалитет,Орис	Orís
отажет,франция,коммуна,Отажет	Hautaget
оно,япония,фукусима,поселок,посёлок,Оно 	Ono,_Fukushima
окно,польша,деревня,куявский-поморский воеводство,Окна 	Okna,_Kuyavian-Pomeranian_Voivodeship
оффенбюттель,германия,коммуна,Оффенбюттель	Offenbüttel
ор,франция,коммуна,верхний гаронна,Ор 	Ore,_Haute-Garonne
окум,япония,посёлок,Окума	Ōkuma,_Fukushima
озерск,россия,калининградский область,Озёрск 	Ozyorsk,_Kaliningrad_Oblast
огненный,болгария,село,Огнен	Ognen
олон,франция,коммуна,верхний гаронна,Олон 	Aulon,_Haute-Garonne
осьно-любуск,польша,город,Осьно-Любуске	Ośno_Lubuskie
ованш,франция,коммуна,Ованш	Ovanches
охос,испания,муниципалитет,Охос	Ojós
омутинский район,россия,село,Омутинский район	Omutinsky_District
ольборг,дания,город,Ольборг	Aalborg
ортесуэла-де-осен,испания,Ортесуэла-де-Осен	Hortezuela_de_Océn
отеван,армения,село,Отеван	Otevan
орханель,турция,город,Орханели	Orhaneli
осор,испания,испания,муниципалитет,Осор 	Osor,_Girona
острув-мазовецк,польша,город,Острув-Мазовецка	Ostrów_Mazowiecka
ордзинуови,италия,город,Ордзинуови	Orzinuovi
одисхайм,германия,коммуна,Одисхайм	Odisheim
огуни,япония,посёлок,ямагата,Огуни 	Oguni,_Yamagata
оз,франция,коммуна,Оза 	Auzat
орисаб,мексика,город,Орисаба	Orizaba
осташков,россия,Осташков	Ostashkov
обершлирбах,австрия,коммуна,Обершлирбах	Oberschlierbach
обинг,германия,коммуна,Обинг	Obing
одр-писуэрг,испания,район,Одра-Писуэрга	Odra-Pisuerga
обервайлер-они-таль,германия,коммуна,Обервайлер-им-Таль	Oberweiler_im_Tal
онгар,ирландия,Онгар	Ongar,_Dublin
орьон,франция,коммуна,Орьон	Orion,_Pyrénées-Atlantiques
омат,перо,город,Омате	Omate
оброчишт,болгария,село,Оброчиште	Obrochishte
округ 07,германия,дюссельдорф,Округ 07 	District_7,_Düsseldorf
остеллато,италия,Остеллато	Ostellato
оберн-хилс,соединять штат америка,город,Оберн-Хилс	Auburn_Hills,_Michigan
острув-велькопольский,польша,город,Острув-Велькопольский	Ostrów_Wielkopolski
обус,франция,коммуна,Обус	Aubous
окан,франция,коммуна,Окана 	Ocana,_Corse-du-Sud
омидийе,иран,город,шахрестан,Омидийе 	Omidiyeh_County
окусывать-амбеный,восточный тимор,город,Окуси-Амбено	Oecusse_District
оберхофен-ама-тунерзкий,швейцария,город,Оберхофен-ам-Тунерзее	Oberhofen_am_Thunersee
ольвето-читр,италия,коммуна,Ольвето-Читра	Oliveto_Citra
острувский повенок,польша,город,мазовецкий воеводство,Острувский повят 	Ostrów_Mazowiecka_County
ожан-мурнед,франция,коммуна,Ожан-Мурнед	Aujan-Mournède
орлеан,франция,город,Орлеан	Orléans
озарк,соединять штат америка,округ,миссури,Озарк 	Ozark_County,_Missouri
онгерманланд,швеция,Онгерманланд	Ångermanland
оледжо-кастелло,италия,коммуна,Оледжо-Кастелло	Oleggio_Castello
ольястро,франция,коммуна,Ольястро	Ogliastro
о-де-сено,франция,О-де-Сен	Hauts-de-Seine
олонецкий район,россия,Олонецкий район	Olonetsky_District
охота,польша,варшава,Охота 	Ochota
оливол,италия,коммуна,Оливола	Olivola
очаков,украина,город,Очаков	Ochakiv
орша,франция,коммуна,Орши	Orchies
ортенбург,германия,коммуна,бавария,Ортенбург 	Ortenburg_(Bavaria)
оттон,италия,Оттоне	Ottone,_Emilia-Romagna
оберриден,швейцария,цюрих,коммуна,Оберриден 	Oberrieden
оялес-де-роа,испания,Оялес-де-Роа	Hoyales_de_Roa
ошануть,болгария,село,Ошаните	Oshanite
ортоландий,бразилия,Ортоландия	Hortolândia
онгль,франция,коммуна,Онгль	Ongles
осас-сюар,франция,коммуна,Осас-Сюар	Ossas-Suhare
оккенхайм,германия,коммуна,Оккенхайм	Ockenheim
обрицберг-руст,австрия,Обрицберг-Руст	Obritzberg-Rust
оршвиллер,франция,коммуна,Оршвиллер	Orschwiller
огасс,испания,Огасса	Ogassa
орать,алжир,вилайет,Оран 	Oran_Province
ореховчик,украина,село,Ореховчик	Orykhivchyk
ольерия,испания,Ольерия	L'Olleria
олинда,бразилия,муниципалитет,Олинда	Olinda
онея,франция,коммуна,Онёй	Auneuil
ориндж,соединять штат америка,город,техас,Ориндж 	Orange,_Texas
орай,индия,город,Орай 	Orai
оз,франция,верхний альпы,коммуна,Оз 	Oze
ондфонтен,франция,коммуна,Ондфонтен	Ondefontaine
обернхоф,германия,коммуна,Обернхоф	Obernhof
ольтный,швейцария,город,Ольтен	Olten
обудовац,республика сербский,Обудовац	Obudovac
оппед,франция,коммуна,Оппед	Oppède
оспедалетто-лодиджано,италия,коммуна,Оспедалетто-Лодиджано	Ospedaletto_Lodigiano
ольшина,польша,гмина,Ольшина 	Gmina_Olszyna
оберзин,германия,Оберзин	Obersinn
ольнуа-су-лан,франция,коммуна,Ольнуа-су-Лан	Aulnois-sous-Laon
оломоуцкий край,чехия,город,Оломоуцкий край	Olomouc_Region
обер-мерлен,германия,коммуна,Обер-Мёрлен	Ober-Mörlen
олдборо,великобритания,город,Олдборо	Aldeburgh
омаэдзаки,япония,город,Омаэдзаки	Omaezaki
ор-акива,израиль,город,Ор-Акива	Or_Akiva
орра,соединять штат америка,город,миннесота,Орр 	Orr,_Minnesota
оттерсберг,германия,коммуна,Оттерсберг	Ottersberg
оутес,испания,Оутес	Outes
огбомошо,нигерия,город,Огбомошо	Ogbomosho
обераул,германия,коммуна,Обераула	Oberaula
ослос,германия,коммуна,Ослос	Osloß
оттерберг,германия,город,Оттерберг	Otterberg
осер,франция,город,Осер	Auxerre
омолон,россия,село,Омолон 	Omolon_(rural_locality)
огастый,соединять штат америка,арканзас,Огаста 	Augusta,_Arkansas
орлица,болгария,село,Орлица 	Orlitsa
оребич,хорватия,община,Оребич	Orebić
орша,белоруссия,город,Орша	Orsha
острожский район,украина,Острожский район	Ostroh_Raion
осло,норвегия,столица,Осло	Oslo
олюторский район,россия,село,Олюторский район	Olyutorsky_District
отранто,италия,Отранто	Otranto
оанес,испания,муниципалитет,Оанес	Ohanes
онтарио,соединять штат америка,нью-йорк,округ,Онтарио 	Ontario_County,_New_York
остель,франция,коммуна,эна,Остель 	Ostel
оддерад,германия,коммуна,Оддераде	Odderade
остерайштедт,германия,коммуна,Остерайштедт	Ostereistedt
оруджлу,азербайджан,село,Оруджлу	Oruçlu,_Kalbajar
обертен,франция,коммуна,Обертен	Aubertin
орельян,эквадор,провинция,город,Орельяна 	Orellana_Province
остров врангель,россия,Остров Врангеля	Wrangel_Island
оберперфус,австрия,коммуна,Оберперфус	Oberperfuss
оллолай,италия,коммуна,Оллолаи	Ollolai
ольмос-де-эсгева,испания,Ольмос-де-Эсгева	Olmos_de_Esgueva
ориджо,италия,коммуна,Ориджо	Origgio
оплани,чехия,община,Оплани	Oplany
оддармеантья,камбоджа,провинция,Оддармеантьей	Oddar_Meanchey_Province
оккьятан,франция,коммуна,Оккьятана	Occhiatana
онет,италия,коммуна,Онета	Oneta,_Lombardy
остров нансен,россия,земля франц-иосиф,Остров Нансена 	Nansena_Island_(Franz_Josef_Land)
обершенег,германия,коммуна,Обершёнег	Oberschönegg
ожен-камтор,франция,коммуна,Ожен-Камтор	Ogenne-Camptort
ось-ле-шато,франция,коммуна,Оси-ле-Шато	Auxi-le-Château
ораниенбаум,германия,саксония-анхальт,район,Ораниенбаум 	Oranienbaum,_Germany
орвинио,италия,коммуна,Орвинио	Orvinio
омарск,босния и герцеговина,Омарска	Omarska
отревиль-сюр-мозель,франция,коммуна,Отревиль-сюр-Мозель	Autreville-sur-Moselle
осиповичи,белоруссия,город,Осиповичи	Asipovichy
обердоллинг,германия,коммуна,Обердоллинг	Oberdolling
ойас,италия,коммуна,Ойас	Oyace
октябрьский район,россия,село,костромской область,Октябрьский район 	Oktyabrsky_District,_Kostroma_Oblast
орляк,болгария,село,Орляк 	Orlyak
оберхоф,германия,город,Оберхоф	Oberhof,_Germany
одивелаш,португалия,феррейра-ду-алентеж,Одивелаш 	Odivelas,_Ferreira_do_Alentejo
оберциссен,германия,коммуна,Оберциссен	Oberzissen
окабина,соединять штат америка,город,миннесота,Окабина 	Okabena,_Minnesota
оргоросый,уругвай,населённый пункт,Оргоросо	Orgoroso
оден,испания,муниципалитет,Одена	Òdena
орлув,польша,село,малопольский воеводство,Орлув 	Orłów,_Lesser_Poland_Voivodeship
ориндж,соединять штат америка,округ,флорида,Ориндж 	Orange_County,_Florida
одсхерред,дания,коммуна,Одсхерред 	Odsherred_Municipality
оберлойсдорф,австрия,коммуна,Оберлойсдорф	Oberloisdorf
ортизей,италия,коммуна,Ортизеи	Urtijëi
оберндорф-ин-тироль,австрия,коммуна,Оберндорф-ин-Тироль	Oberndorf_in_Tirol
оберрида-ама-бринцерзкий,швейцария,коммуна,Оберрид-ам-Бринцерзее	Oberried_am_Brienzersee
островский район,россия,псковский область,Островский район 	Ostrovsky_District,_Pskov_Oblast
от,франция,коммуна,От 	Authe
онс-ди-питанг,бразилия,Онса-ди-Питанги	Onça_de_Pitangui
окильяс,испания,Окильяс	Oquillas
обжа,франция,коммуна,Обжа 	Objat
оринья,франция,коммуна,Ориньи	Origny
окур-мулен,франция,коммуна,Окур-Мулен	Haucourt-Moulaine
обердраубург,австрия,Обердраубург	Oberdrauburg
орсный,франция,коммуна,Орсён	Orsennes
они,бельгия,бельгия,коммуна,Оне 	Onhaye
октябрьский район,россия,калмыкия,Октябрьский район 	Oktyabrsky_District,_Republic_of_Kalmykia
ордубад,азербайджан,город,Ордубад	Ordubad
окалус,соединять штат америка,округ,флорида,Окалуса 	Okaloosa_County,_Florida
оводда,италия,коммуна,Оводда	Ovodda
оргозоло,италия,коммуна,Оргозоло	Orgosolo
ороно,соединять штат америка,город,миннесота,Ороно 	Orono,_Minnesota
оттан,италия,коммуна,Оттана	Ottana
олешица,польша,гмина,Олешице 	Gmina_Oleszyce
оллендорф,германия,коммуна,Оллендорф	Ollendorf
обервизный,германия,коммуна,Обервизен	Oberwiesen
оршвир,франция,коммуна,Оршвир	Orschwihr
оратовский район,украина,посёлок,Оратовский район	Orativ_Raion
оханск,россия,город,Оханск	Okhansk
оменья,италия,коммуна,Оменья	Omegna
ореховский район,украина,Ореховский район	Orikhiv_Raion
огродзенец,польша,Огродзенец	Ogrodzieniec
орор,канада,онтарио,город,Орора 	Aurora,_Ontario
оярсун,испания,муниципалитет,Оярсун	Oiartzun
осон,франция,верхний сона,коммуна,Осон 	Auxon,_Haute-Saône
орансан,франция,жер,коммуна,Орансан 	Aurensan,_Gers
орносый,испания,город,Орнос	Hornos
очаково-матвеевский,россия,район,Очаково-Матвеевское	Ochakovo-Matveyevskoye_District
отрожный,россия,чукотский автономный округ,Отрожный 	Otrozhny,_Chukotka_Autonomous_Okrug
обстальден,швейцария,коммуна,гларус,Обстальден 	Obstalden
ольмшайд,германия,коммуна,Ольмшайд	Olmscheid
обернкирхен,германия,город,Обернкирхен	Obernkirchen
омский область,россия,город,Омская область	Omsk_Oblast
отасилиу-коста,бразилия,Отасилиу-Коста	Otacílio_Costa
округ 05,германия,дюссельдорф,Округ 05 	District_5,_Düsseldorf
олайне,латвия,город,Олайне	Olaine
оберндорф-на-леха,германия,коммуна,Оберндорф-на-Лехе	Oberndorf_am_Lech
очосондьюп,намибия,город,Очосондьюпа	Otjozondjupa_Region
оропес-дель-мара,испания,Оропеса-дель-Мар	Oropesa_del_Mar
оберхаузен,германия,коммуна,бад-бергцаберн,Оберхаузен 	Oberhausen,_Südliche_Weinstraße
одорхей-секуеск,румыния,город,Одорхею-Секуеск	Odorheiu_Secuiesc
орадур,франция,шарант,коммуна,Орадур 	Oradour,_Charente
орешница,болгария,село,Орешница	Oreshnitsa
обручевский район,россия,Обручевский район	Obruchevsky_District
онд,франция,коммуна,Онд	Ondes
оберхаузен-бай-кирн,германия,коммуна,Оберхаузен-бай-Кирн	Oberhausen_bei_Kirn
оппеть,соединять штат америка,арканзас,Оппело 	Oppelo,_Arkansas
оберперинг,германия,коммуна,Оберпёринг	Oberpöring
ольденбург,германия,Ольденбург	Oldenburg
онуфриевский район,украина,Онуфриевский район	Onufriivka_Raion
олдни,соединять штат америка,город,миннесота,Олден 	Alden,_Minnesota
опочецкий район,россия,город,Опочецкий район	Opochetsky_District
о’каллахансмилс,ирландия,деревня,О’Каллахансмилс	O'Callaghans_Mills
оркахо-де-ла-сьерра,испания,муниципалитет,Оркахо-де-ла-Сьерра	Horcajo_de_la_Sierra
онтальбилие,испания,Онтальбилья	Hontalbilla
ойгендорф,австрия,Ойгендорф	Eugendorf
олбануть,соединять штат америка,нью-йорк,округ,Олбани 	Albany_County,_New_York
орловат,сербия,населённый пункт,Орловат	Orlovat
оттендорф-окрилла,германия,коммуна,Оттендорф-Окрилла	Ottendorf-Okrilla
ойердорф,германия,коммуна,Ойердорф	Euerdorf
орчано-ди-пезаро,италия,коммуна,Орчано-ди-Пезаро	Orciano_di_Pesaro
оделеть,португалия,район,Оделейте	Odeleite
опанец,болгария,добричский область,село,Опанец 	Opanets,_Dobrich_Province
ольский городской округ,россия,посёлок,Ольский городской округ	Olsky_District
огденсберг,соединять штат америка,город,Огденсберг	Ogdensburg,_New_York
окампо,мексика,муниципалитет,чиуауа,Окампо 	Ocampo_Municipality,_Chihuahua
озан,франция,коммуна,Озан 	Ozan,_Ain
оранг,пакистан,Оранги	Orangi_Town
остхофен,германия,город,Остхофен	Osthofen
обереша,швейцария,коммуна,Оберёш	Oberösch
ольвес,испания,Ольвес	Olvés
островица,болгария,село,Островица	Ostrovitsa
орехать,испания,муниципалитет,Орехана	Orejana
обербиллиг,германия,коммуна,Обербиллиг	Oberbillig
ойтный,германия,коммуна,Ойтен	Oyten
ортале,франция,коммуна,Ортале	Ortale
оццано-монферрато,италия,коммуна,Оццано-Монферрато	Ozzano_Monferrato
орель-верлак,франция,коммуна,Орель-Верлак	Aurelle-Verlac
онифая,италия,коммуна,Онифаи	Onifai
олькуш,польша,город,Олькуш	Olkusz
ормеа,италия,коммуна,Ормеа	Ormea
обинья,франция,кальвадос,коммуна,Обиньи 	Aubigny,_Calvados
ольстер,великобритания,Ольстер	Ulster
орос,бразилия,город,бразилия,Орос 	Orós
оберкац,германия,коммуна,Оберкац	Oberkatz
оберар,германия,коммуна,Оберар	Oberahr
озный,италия,коммуна,Ознаго	Osnago
остерштедт,германия,коммуна,Остерштедт	Osterstedt
обер-рамштадт,германия,город,Обер-Рамштадт	Ober-Ramstadt
орадур,франция,коммуна,канталь,Орадур 	Oradour,_Cantal
ортенау,германия,район,Ортенау 	Ortenaukreis
острогожский район,россия,Острогожский район	Ostrogozhsky_District
орпьер,франция,коммуна,Орпьер	Orpierre
отерлек,нидерланды,деревня,Отерлек	Oterleek
отто-ле-баг,франция,коммуна,Отто-ле-Баг	Hottot-les-Bagues
обоянский район,россия,Обоянский район	Oboyansky_District
ольдендорф,германия,коммуна,луэ,Ольдендорф 	Oldendorf_(Luhe)
осон,франция,об,коммуна,Осон 	Auxon,_Aube
орроли,италия,коммуна,Орроли	Orroli
оберзимтен,германия,коммуна,Оберзимтен	Obersimten
орать-бранка,бразилия,риу-гранди-ду-норти,Ору-Бранку 	Ouro_Branco,_Rio_Grande_do_Norte
оваро,италия,Оваро	Ovaro
онуфриевский район,украина,посёлок,Онуфриевский район	Onufriivka_Raion
оранж,франция,город,Оранж	Orange,_Vaucluse
олдамбт,нидерланды,община,Олдамбт	Oldambt_(municipality)
ольмильос-де-кастро,испания,Ольмильос-де-Кастро	Olmillos_de_Castro
оксфордшир,великобритания,Оксфордшир	Oxfordshire
оча,венгрия,город,Оча	Ócsa
ор,бельгия,бельгия,коммуна,Оре 	Oreye
оберкуннерсдорф,германия,коммуна,Оберкуннерсдорф	Obercunnersdorf
оберельц,германия,коммуна,Оберельц	Oberelz
обервельц-штадт,австрия,город,Обервёльц-Штадт	Oberwölz_Stadt
осорный,чили,город,Осорно	Osorno,_Chile
окен,франция,коммуна,Окён	Aucun
олдрич,соединять штат америка,город,миннесота,Олдрич 	Aldrich,_Minnesota
очаковский район,украина,город,Очаковский район	Ochakiv_Raion
обервис,германия,коммуна,Обервис	Oberwies
оливейра-дус-брежиньюс,бразилия,Оливейра-дус-Брежиньюс	Oliveira_dos_Brejinhos
олд-орчард-бич,соединять штат америка,город,мэн,Олд-Орчард-Бич 	Old_Orchard_Beach,_Maine
олье-д’агуа-ду-боржис,бразилия,Олью-д’Агуа-ду-Боржис	Olho-d'Água_do_Borges
омоа,франция,Омоа	Omo'a
одринци,болгария,добричский область,село,Одринци 	Odrintsi,_Dobrich_Province
озвиль-толозан,франция,коммуна,Озвиль-Толозан	Auzeville-Tolosane
овад,италия,коммуна,Овада	Ovada
ольянико,италия,коммуна,Ольянико	Oglianico
орлов,россия,город,Орлов 	Orlov,_Kirov_Oblast
омбрадос,испания,Омбрадос	Hombrados
орлово,болгария,село,хасковский область,Орлово 	Orlovo,_Haskovo_Province
обервайлер,германия,айфель,коммуна,Обервайлер 	Oberweiler
оленхард,германия,коммуна,Оленхард	Ohlenhard
олевать-романо,италия,коммуна,Олевано-Романо	Olevano_Romano
окуловский район,россия,Окуловский район	Okulovsky_District
округ 03,германия,дюссельдорф,Округ 03 	District_3,_Düsseldorf
обераммергау,германия,коммуна,Обераммергау	Oberammergau
онань,италия,коммуна,Онани	Onanì
ориландий-ду-норти,бразилия,Ориландия-ду-Норти	Ourilândia_do_Norte
оксовский,россия,посёлок,Оксовский	Oksovsky
ольтинген,швейцария,коммуна,Ольтинген	Oltingen
одюбон,соединять штат америка,айова,город,Одюбон 	Audubon,_Iowa
отреманкур,франция,коммуна,Отреманкур	Autremencourt
остерхольц,германия,район,Остерхольц 	Osterholz
островец,болгария,болгария,село,Островец 	Ostrovets
онд-верди,бразилия,Онда-Верди	Onda_Verde
от,франция,мерт  мозель,коммуна,От 	Othe
обертребро,германия,коммуна,Обертребра	Obertrebra
оппенберг,австрия,штирия,коммуна,Оппенберг 	Oppenberg
олокау-дель-рей,испания,Олокау-дель-Рей	Olocau_del_Rey
ориуэла,испания,город,Ориуэла	Orihuela
окснард,соединять штат америка,Окснард	Oxnard,_California
одаленго-пикколо,италия,коммуна,Одаленго-Пикколо	Odalengo_Piccolo
опьо,франция,коммуна,Опьо	Opio,_Alpes-Maritimes
омутнинск,россия,город,Омутнинск	Omutninsk
оттобойрен,германия,коммуна,Оттобойрен	Ottobeuren
орель,франция,коммуна,воклюз,Орель 	Aurel,_Vaucluse
округ 01,германия,дюссельдорф,Округ 01 	District_1,_Düsseldorf
орнуа-ле-бур,франция,коммуна,Орнуа-ле-Бур	Hornoy-le-Bourg
оршанский район,россия,марья эл,Оршанский район 	Orshansky_District
ориньяк,франция,коммуна,верхний гаронна,Ориньяк 	Aurignac
орсаго,италия,коммуна,Орсаго	Orsago
обербипп,швейцария,коммуна,Обербипп	Oberbipp
острый-орштедт,германия,коммуна,Остер-Орштедт	Oster-Ohrstedt
онега,россия,город,Онега 	Onega,_Russia
ольсбах,германия,коммуна,Ольсбах	Ohlsbach
орхангази,турция,город,Орхангази	Orhangazi
оберрордорф,швейцария,коммуна,Оберрордорф	Oberrohrdorf
окленд,соединять штат америка,флорида,Окленд 	Oakland,_Florida
ор,франция,франция,коммуна,Оре 	Auray
орланци,республика македония,село,община арачиново,Орланци 	Orlanci
отмухув,польша,Отмухув	Otmuchów
ойо,нигерия,город,Ойо 	Oyo,_Oyo_State
обервамб,германия,коммуна,Обервамбах	Oberwambach
орсанко,франция,коммуна,Орсанко	Orsanco
остабат-асма,франция,коммуна,Остабат-Асм	Ostabat-Asme
осиковый,болгария,село,благоевградский область,Осиково 	Osikovo,_Blagoevgrad_Province
одресь,франция,коммуна,Одреси	Haudrecy
ортенберг,германия,город,гессен,Ортенберг 	Ortenberg,_Hesse
ойон,перо,провинция,Ойон 	Oyón_Province
ороп,греция,Ороп	Oropos
окленд-парк,соединять штат америка,город,Окленд-Парк	Oakland_Park,_Florida
омбес-де-лавалье,уругвай,город,Омбес-де-Лавалье	Ombúes_de_Lavalle
офтринген,швейцария,коммуна,Офтринген	Oftringen
оже-ле-бен,франция,коммуна,Ожё-ле-Бен	Ogeu-les-Bains
ориньюс,бразилия,муниципалитет,Ориньюс	Ourinhos
оберурнять,швейцария,коммуна,Оберурнен	Oberurnen
оберштадтфельд,германия,коммуна,Оберштадтфельд	Oberstadtfeld
оффанья,италия,коммуна,Оффанья	Offagna
ольштын,польша,город,Ольштын	Olsztyn
оберцайринг,австрия,Оберцайринг	Oberzeiring
олово,босния и герцеговина,босния и герцеговина,город,Олово 	Olovo
отирать-иссар,франция,коммуна,Отри-Иссар	Autry-Issards
обертиллиах,австрия,коммуна,Обертиллиах	Obertilliach
осон,франция,округ сено-годенс,коммуна,Осон 	Ausson
офен,италия,коммуна,Офена	Ofena
орор,соединять штат америка,южный дакота,округ,Орора 	Aurora_County,_South_Dakota
оттштедт-ама-берг,германия,коммуна,Оттштедт-ам-Берге	Ottstedt_am_Berge
осун,испания,населённый пункт,Осуна	Osuna
оффид,италия,коммуна,Оффида	Offida
орцево,болгария,село,Орцево	Ortsevo
ориндж,соединять штат америка,калифорния,округ,Ориндж 	Orange_County,_California
оденсе,дания,Оденсе	Odense
оберрод,германия,коммуна,Оберрод	Oberrod
омблиер,франция,коммуна,Омблиер	Homblières
оливейринья,португалия,Оливейринья	Oliveirinha
оберстенфельд,германия,коммуна,Оберстенфельд	Oberstenfeld
охинага,мексика,город,Охинага	Ojinaga
огузский район,азербайджан,Огузский район	Oghuz_District
обриеж,босния и герцеговина,село,Обриеж	Obrijež
остье,франция,коммуна,Остья	Hostiaz
озоппо,италия,Озоппо	Osoppo
одаленго-гранд,италия,коммуна,Одаленго-Гранде	Odalengo_Grande
ольгер,испания,муниципалитет,Ольгера	Holguera
отрить,франция,алье,коммуна,Отрив 	Hauterive,_Allier
обершнайдинг,германия,коммуна,Обершнайдинг	Oberschneiding
озаска,бразилия,город,Озаску	Osasco
обервир,германия,коммуна,Обервира	Oberwiera
оринья-сент-бенуат,франция,коммуна,Ориньи-Сент-Бенуат	Origny-Sainte-Benoite
осен-э-англь,франция,коммуна,Осён-э-Англь	Ossun-ez-Angles
ортадж,турция,город,Ортаджа	Ortaca
ольденбург,германия,район,Ольденбург 	Oldenburg_(district)
обертраублинг,германия,коммуна,Обертраублинг	Obertraubling
ольшанский район,украина,Ольшанский район	Vilshanka_Raion
орм,франция,об,коммуна,Орм 	Ormes,_Aube
орт-они-иннкрайс,австрия,коммуна,Орт-им-Иннкрайс	Ort_im_Innkreis
орс,испания,населённый пункт,Орсе	Orce
ольмичча,франция,коммуна,Ольмичча	Olmiccia
одоевский район,россия,Одоевский район	Odoyevsky_District
оттерндорф,германия,город,Оттерндорф	Otterndorf
оржеваль,франция,коммуна,эна,Оржеваль 	Orgeval,_Aisne
орнет,польша,гмина,Орнета 	Gmina_Orneta
отцинг,германия,коммуна,Отцинг	Otzing
ортачезус,италия,коммуна,Ортачезус	Ortacesus
обердиб,германия,коммуна,Обердибах	Oberdiebach
оберглатт,швейцария,коммуна,Оберглатт	Oberglatt
обергюнцбург,германия,коммуна,Обергюнцбург	Obergünzburg
омаха,соединять штат америка,Омаха	Omaha,_Nebraska
орьяк-сюр-вандинель,франция,коммуна,Орьяк-сюр-Вандинель	Auriac-sur-Vendinelle
овручский район,украина,город,Овручский район	Ovruch_Raion
орать-бранка,бразилия,муниципалитет,алагоас,Ору-Бранку 	Ouro_Branco,_Alagoas
остербуркен,германия,город,Остербуркен	Osterburken
осекать,польша,гмина,сташувский повенок,Осек 	Gmina_Osiek,_Świętokrzyskie_Voivodeship
отр-ле-сера,франция,коммуна,Отре-ле-Сер	Autrey-lès-Cerre
опицвет,болгария,село,Опицвет	Opitsvet
оберлихтенау,германия,коммуна,Оберлихтенау	Oberlichtenau
омахек,намибия,город,Омахеке	Omaheke_Region
одар,франция,коммуна,Одар 	Odars
онтэрио,соединять штат америка,калифорния,город,Онтэрио 	Ontario,_California
онайда,соединять штат америка,нью-йорк,округ,Онайда 	Oneida_County,_New_York
ольшан,украина,черкасский область,посёлок,Ольшана 	Vilshana
орт-де-сан-жоан,испания,Орта-де-Сан-Жоан	Horta_de_Sant_Joan
осувка,польша,деревня,куявский-поморский воеводство,Осувка 	Osówka,_Kuyavian-Pomeranian_Voivodeship
оппа,германия,коммуна,Оппах	Oppach
октябрьский район,россия,село,приморский край,Октябрьский район 	Oktyabrsky_District,_Primorsky_Krai
окуловка,россия,город,Окуловка	Okulovka_(town),_Novgorod_Oblast
оберзаксен,швейцария,коммуна,Оберзаксен	Obersaxen
ормсби,соединять штат америка,город,миннесота,Ормсби 	Ormsby,_Minnesota
ольп,германия,город,Ольпе	Olpe,_Germany
они,франция,об,коммуна,Оне 	Aulnay,_Aube
обертраун,австрия,коммуна,Обертраун	Obertraun
омерля,турция,город,Омерли	Ömerli,_Mardin
охойно,польша,село,Охойно	Ochojno
отсиго,соединять штат америка,город,миннесота,Отсиго 	Otsego,_Minnesota
олдтаун,ирландия,деревня,фингал,Олдтаун 	Oldtown,_Dublin
обазин,франция,коммуна,Обазин	Aubazine
обербукситный,швейцария,коммуна,Обербукситен	Oberbuchsiten
оберверресбах,германия,коммуна,Обервёрресбах	Oberwörresbach
отог-ци,китайский народный республика,Отог-Ци	Otog_Banner
остерхорн,германия,коммуна,Остерхорн	Osterhorn
обероппург,германия,коммуна,Обероппург	Oberoppurg
оротелль,италия,коммуна,Оротелли	Orotelli
обернойкирхен,австрия,Обернойкирхен	Oberneukirchen,_Austria
откур-романеш,франция,коммуна,Откур-Романеш	Hautecourt-Romanèche
остерберг,германия,коммуна,Остерберг	Osterberg
ориндиув,бразилия,Ориндиува	Orindiúva
орюкто,республика корея,Орюкто	Oryukdo
обтр,франция,коммуна,Обтре	Obtrée
осеново,болгария,варненский область,село,Осеново 	Osenovo,_Varna_Province
ольмет-ди-капокорсо,франция,коммуна,Ольмета-ди-Капокорсо	Olmeta-di-Capocorso
оз,франция,жер,коммуна,Оз 	Éauze
ойцув,польша,село,Ойцув	Ojców
ольмос-де-пеньяфьель,испания,Ольмос-де-Пеньяфьель	Olmos_de_Peñafiel
онтория-де-ла-кантер,испания,Онтория-де-ла-Кантера	Hontoria_de_la_Cantera
осака,япония,город,Осаки 	Ōsaki,_Miyagi
орлов-могила,болгария,село,Орлова-Могила	Orlova_mogila
опперсхаузен,германия,коммуна,Опперсхаузен	Oppershausen
отеро,испания,Отеро	Otero_(Spain)
оденвальд,германия,район,Оденвальд 	Odenwaldkreis
орать,франция,коммуна,Орю	Orus
орньяк-л’аван,франция,коммуна,Орньяк-л’Аван	Orgnac-l'Aven
обердорл,германия,коммуна,Обердорла	Oberdorla
омония,греция,район,район афины,Омония 	Omonoia,_Athens
ория,испания,испания,населённый пункт,Ория 	Oria,_Spain
оханский район,россия,город,Оханский район	Okhansky_District
оччимьяно,италия,коммуна,Оччимьяно	Occimiano
отог-цяньци,китайский народный республика,Отог-Цяньци	Otog_Front_Banner
обервиль,швейцария,коммуна,базель-ланды,Обервиль 	Oberwil,_Basel-Landschaft
ольджинат,италия,коммуна,Ольджинате	Olginate
обергерлафинген,швейцария,коммуна,Обергерлафинген	Obergerlafingen
cityname,name,cityname	city
орхомен,греция,беотия,Орхомен 	Orchomenus_(Boeotia)
острог,украина,город,Острог 	Ostroh
обервиль-бюрный,швейцария,коммуна,Обервиль-Бюрен	Oberwil_bei_Büren
обершварц,германия,коммуна,Обершварцах	Oberschwarzach
орестиада,греция,город,Орестиада 	Orestiada
осташковский район,россия,город,Осташковский район	Ostashkovsky_District
оттендорф,германия,киль,коммуна,Оттендорф 	Ottendorf,_Schleswig-Holstein
обу,япония,город,Обу	Ōbu,_Aichi
одзун,армения,село,Одзун	Odzun
ойлаталь,германия,коммуна,Ойлаталь	Eulatal
опузен,хорватия,город,Опузен	Opuzen
одан,франция,муниципалитет,Одан	Hodent
орловци,болгария,село,Орловци	Orlovtsi
осийка,хорватия,город,Осиек	Osijek
офтершванг,германия,коммуна,Офтершванг	Ofterschwang
орисвилл,соединять штат америка,Орисвилл	Auriesville,_New_York
ортуккьо,италия,коммуна,Ортуккьо	Ortucchio
оберегга,швейцария,швейцария,коммуна,Оберегг 	Oberegg_District
обернау,германия,коммуна,вестервальд,Обернау 	Obernau
орто-тока,киргизия,посёлок,Орто-Токой	Orto-Tokoy
орашие,босния и герцеговина,Орашье	Orašje
оржицкий район,украина,Оржицкий район	Orzhytsia_Raion
опера,италия,муниципалитет,коммуна,Опера 	Opera,_Lombardy
оримонт,франция,коммуна,Оримонт	Aurimont
ойрасбург,германия,верхний бавария,коммуна,Ойрасбург 	Eurasburg
охир,япония,село,Охира	Ōhira,_Miyagi
орсер,испания,город,Орсера	Orcera
отрюш,франция,коммуна,Отрюш 	Autruche
ондр,франция,коммуна,Ондр	Ondres
овиллер-ле-форж,франция,коммуна,Овиллер-ле-Форж	Auvillers-les-Forges
оберштадт,германия,коммуна,Оберштадт	Oberstadt
оливарес-де-дуэро,испания,Оливарес-де-Дуэро	Olivares_de_Duero
отори,франция,коммуна,Оторей	Autoreille
ося,япония,город,Осю	Ōshū,_Iwate
обон,испания,испания,Обон 	Obón
озазио,италия,коммуна,Озазио	Osasio
ордис,испания,Ордис	Ordis
ориллий,канада,онтарио,город,Ориллия 	Orillia
островецкий повенок,польша,город,Островецкий повят	Ostrowiec_County
ольтрессенд-альт,италия,коммуна,Ольтрессенда-Альта	Oltressenda_Alta
оттрау,германия,коммуна,Оттрау	Ottrau
отирать,франция,коммуна,Отри 	Autry
обериберг,швейцария,коммуна,Обериберг	Oberiberg
опатувский повенок,польша,город,Опатувский повят	Opatów_County
остров,чехия,город,карловарский край,Остров 	Ostrov_(Karlovy_Vary_District)
одровонж,польша,свентокшиский воеводство,село,Одровонж 	Odrowąż,_Świętokrzyskie_Voivodeship
оточац,хорватия,город,Оточац	Otočac
оломбрада,испания,муниципалитет,Оломбрада	Olombrada
обреж век,молдавия,село,Обрежа Веке	Obreja_Veche
орда,россия,село,Орда 	Orda,_Perm_Krai
оудсхорн,южно-африканский республика,Оудсхорн	Oudtshoorn
орание,южно-африканский республика,Орания	Orania,_Northern_Cape
островский район,россия,город,псковский область,Островский район 	Ostrovsky_District,_Pskov_Oblast
орехово-зуевский район,россия,Орехово-Зуевский район	Orekhovo-Zuyevsky_District
озарк,соединять штат америка,арканзас,Озарк 	Ozark,_Arkansas
ойон,испания,город,Ойон	Oyón-Oion
оберштайнеб,германия,коммуна,Оберштайнебах	Obersteinebach
оберпфаффенхофен,германия,посёлок,Оберпфаффенхофен	Oberpfaffenhofen
осинник,россия,город,Осинники	Osinniki
они,грузия,город,Они 	Oni,_Georgia
ойя-де-уэск,испания,район,Ойя-де-Уэска	Hoya_de_Huesca/Plana_de_Uesca
онсдорф,германия,коммуна,Онсдорф	Onsdorf
оконь,соединять штат америка,округ,джорджия,Окони 	Oconee_County,_Georgia
ош,киргизия,город,киргизия,Ош 	Osh
орджоникидзевский район,россия,посёлок,хакасия,Орджоникидзевский район 	Ordzhonikidzevsky_District,_Republic_of_Khakassia
ополе-любельск,польша,город,Ополе-Любельске	Opole_Lubelskie
оседло-локетка,польша,село,Оседле-Локетка	Osiedle_Łokietka
о-бонн,франция,коммуна,О-Бонн	Eaux-Bonnes
островец,белоруссия,Островец	Astravyets
обервезель,германия,город,Обервезель	Oberwesel
остров тиви,австралия,Острова Тиви	Tiwi_Islands
ольястр,италия,провинция,Ольястра	Province_of_Ogliastra
оффенбах,германия,город,Оффенбах 	Offenbach_am_Main
обручевский район,россия,район,Обручевский район	Obruchevsky_District
ольцхайм,германия,коммуна,Ольцхайм	Olzheim
олокау,испания,Олокау	Olocau
октябрьский,россия,посёлок,красногвардейский район,Октябрьское 	Oktiabrske
обел,болгария,село,Обел 	Obel,_Bulgaria
острау,германия,залькрайс,коммуна,Острау 	Ostrau,_Saxony-Anhalt
ойскирхен,германия,город,Ойскирхен	Euskirchen
обернхайм,германия,коммуна,Обернхайм	Obernheim
обердердинген,германия,коммуна,Обердердинген	Oberderdingen
оля,франция,коммуна,Оли	Haulies
оррия,италия,коммуна,Оррия	Orria
осинский район,россия,иркутский область,Осинский район 	Osinsky_District,_Irkutsk_Oblast
олдтаун,ирландия,деревня,роскоммон,Олдтаун 	Old_Town,_County_Roscommon
ос-марсийон,франция,коммуна,Ос-Марсийон	Os-Marsillon
ож,франция,крез,коммуна,Ож 	Auge,_Creuse
обнинск,россия,Обнинск	Obninsk
оттобьяно,италия,коммуна,Оттобьяно	Ottobiano
острау,германия,коммуна,саксония,Острау 	Ostrau,_Saxony
оффенау,германия,коммуна,Оффенау	Offenau
окинава,япония,Окинава	Okinawa_Island
олгин,эстония,Олгина	Olgina
ордзивекка,италия,коммуна,Ордзивекки	Orzivecchi
остраудерфный,германия,коммуна,Остраудерфен	Ostrhauderfehn
отивар,испания,муниципалитет,Отивар	Otívar
оберварт,австрия,город,Оберварт	Oberwart
орсар-бормида,италия,коммуна,Орсара-Бормида	Orsara_Bormida
оберштоккен,швейцария,коммуна,Оберштоккен	Oberstocken
озд,венгрия,город,Озд	Ózd
обухов,украина,город,Обухов 	Obukhiv
ольдендорф,германия,коммуна,штад,Ольдендорф 	Oldendorf,_Stade
овчево,болгария,село,Овчево	Ovchevo
онежский район,россия,Онежский район	Onezhsky_District
орехово-зуево,россия,город,Орехово-Зуево	Orekhovo-Zuyevo
обертруб,германия,коммуна,Обертрубах	Obertrubach
оруа,франция,коммуна,Оруа	Oroix
олес-де-монсеррат,испания,Олеса-де-Монсеррат	Olesa_de_Montserrat
обербез,германия,коммуна,Обербёза	Oberbösa
ондо,нигерия,штат,Ондо 	Ondo_State
остров,россия,город,Остров 	Ostrov,_Ostrovsky_District,_Pskov_Oblast
ос-де-хак,испания,муниципалитет,Ос-де-Хака	Hoz_de_Jaca
оберельсбах,германия,коммуна,Оберельсбах	Oberelsbach
оркахо-де-ласа-торрес,испания,Оркахо-де-лас-Торрес	Horcajo_de_las_Torres
омишаль,хорватия,община,Омишаль	Omišalj
омб,германия,коммуна,Омбах	Ohmbach
оисо,япония,посёлок,Оисо	Ōiso,_Kanagawa
осовец-крепость,польша,город,Осовец-Крепость	Osowiec-Twierdza
овьедо,испания,город,Овьедо 	Oviedo
оринья-ан-тьераш,франция,коммуна,Ориньи-ан-Тьераш	Origny-en-Thiérache
ошакан,армения,село,Ошакан	Oshakan
окаханджа,намибия,Окаханджа	Okahandja
олльный,франция,мозель,коммуна,Оллен 	Holling,_Moselle
офаким,израиль,город,Офаким	Ofakim
остбеверн,германия,коммуна,Остбеверн	Ostbevern
озио-сопер,италия,коммуна,Озио-Сопра	Osio_Sopra
оберхаузен-на-аппель,германия,коммуна,Оберхаузен-на-Аппеле	Oberhausen_an_der_Appel
октябрьский район,россия,посёлок,калмыкия,Октябрьский район 	Oktyabrsky_District,_Republic_of_Kalmykia
овиллар-сюр-сон,франция,коммуна,Овиллар-сюр-Сон	Auvillars-sur-Saône
оливейра-ду-дора,португалия,населённый пункт,вила-новый-де-гайа,Оливейра-ду-Дору 	Oliveira_do_Douro,_Vila_Nova_de_Gaia
осон,франция,коммуна,кот-д’ор,Осон 	Auxonne
оймяконский улус,россия,посёлок,Оймяконский улус	Oymyakonsky_District
офельгюнна,германия,коммуна,Офельгюнне	Ovelgünne
остерод,германия,район,Остероде 	Osterode_(district)
обервальтерсдорф,австрия,Обервальтерсдорф	Oberwaltersdorf
обердишинген,германия,коммуна,Обердишинген	Oberdischingen
оберхельдрунгены,германия,коммуна,Оберхельдрунген	Oberheldrungen
олдмелдрум,великобритания,Олдмелдрум	Oldmeldrum
охтендунг,германия,коммуна,Охтендунг	Ochtendung
орт,португалия,азорский остров,город,Орта 	Horta,_Azores
орбита,испания,авила,муниципалитет,Орбита 	Orbita,_Ávila
опаленица,польша,город,Опаленица	Opalenica
оренса,испания,район,комарка,Оренсе 	Ourense_(comarca)
орать,алжир,Оран	Oran
онич,нигерия,город,Онича	Onitsha
орать-фин,бразилия,Ору-Фину	Ouro_Fino
оборник-сленск,польша,город,Оборники-Слёнске	Oborniki_Śląskie
озани,франция,коммуна,Озани	Osani
орбис,германия,коммуна,Орбис	Orbis,_Rhineland-Palatinate
ото,соединять штат америка,округ,небраска,Ото 	Otoe_County,_Nebraska
ондалснести,норвегия,город,Ондалснес	Åndalsnes
осон,испания,район,комарка,Осона 	Osona
оризарь,болгария,село,Оризаре	Orizare
остбург,нидерланды,город,Остбург	Oostburg
обвиль,франция,коммуна,Обвиль	Aubeville
ойтина,германия,город,Ойтин	Eutin
ораниенбург,германия,город,Ораниенбург 	Oranienburg
орфген,германия,коммуна,Орфген	Orfgen
орешино,болгария,село,Орешино	Oreshino
обуховский район,украина,Обуховский район	Obukhiv_Raion
оах,соединять штат америка,Оаху	Oahu
остроботний,финляндия,провинция,город,Остроботния 	Ostrobothnia_(region)
ордизан,франция,коммуна,Ордизан	Ordizan
остров октябрьский революция,россия,Остров Октябрьской Революции	October_Revolution_Island
оттенхофен,германия,коммуна,Оттенхофен	Ottenhofen
одринци,болгария,село,хасковский область,Одринци 	Odrintsi,_Haskovo_Province
оринья-ле-сечь,франция,коммуна,Ориньи-ле-Сек	Origny-le-Sec
охос-негрос,испания,муниципалитет,Охос-Негрос	Ojos_Negros,_Teruel
орьоль,франция,коммуна,Орьоль	Oriolles
оберуккерз,германия,коммуна,Оберуккерзе	Oberuckersee
овчарь,болгария,село,Овчари	Ovchari
окотепек,мексика,муниципалитет,муниципалитет чьяпас,Окотепек 	Ocotepec,_Chiapas
ольшанский район,украина,посёлок,Ольшанский район	Vilshanka_Raion
орнезон,франция,коммуна,Орнезон	Ornaisons
оливейра-ди-аземейши,португалия,город,Оливейра-ди-Аземейш	Oliveira_de_Azeméis,_Santiago_de_Riba-Ul,_Ul,_Macinhata_da_Seixa_e_Madail
обинья-ла-ронс,франция,коммуна,Обиньи-ла-Ронс	Aubigny-la-Ronce
орор,соединять штат америка,город,колорадо,Орора 	Aurora,_Colorado
осумасинт,мексика,Осумасинта	Osumacinta
орт-сан-джулио,италия,коммуна,Орта-Сан-Джулио	Orta_San_Giulio
орлянин,болгария,село,Орляне	Orlyane
обиньоск,франция,коммуна,Обиньоск	Aubignosc
обердорф,швейцария,коммуна,золотурн,Обердорф 	Oberdorf,_Solothurn
одер-шпра,германия,район,Одер-Шпре 	Oder-Spree
онтиньен,испания,Онтиньена	Ontiñena
орейан,франция,верхний пиренеи,коммуна,Орейан 	Aureilhan,_Hautes-Pyrénées
острув-любельский,польша,гмина,Острув-Любельский 	Gmina_Ostrów_Lubelski
оберкремер,германия,коммуна,Оберкремер	Oberkrämer
обантон,франция,коммуна,Обантон	Aubenton
оберрида,германия,коммуна,брайсгау,Оберрид 	Oberried,_Baden-Württemberg
оберпуллендорф,австрия,округ,Оберпуллендорф 	Oberpullendorf_District
орда,турция,город,Орду	Ordu
ойо-де-мансанарес,испания,город,Ойо-де-Мансанарес	Hoyo_de_Manzanares
орьон-идерн,франция,коммуна,Орьон-Идерн	Aurions-Idernes
орукун,австралия,община,Орукун	Aurukun,_Queensland
отырарский район,казахстан,район,Отырарский район	Otyrar_District
орос,россия,Оросу	Orosu
орч,испания,населённый пункт,Орче	Horche
ока-парк-хайтс,соединять штат америка,город,миннесота,Ок-Парк-Хайтс 	Oak_Park_Heights,_Minnesota
ольсберг,германия,город,Ольсберг	Olsberg,_Germany
ожиш,польша,гмина,Ожиш 	Gmina_Orzysz
онья,франция,коммуна,Оньи	Augny
орьенте,испания,район,комарка,Орьенте 	Oriente_(comarca)
ольхонский район,россия,Ольхонский район	Olkhonsky_District
ога,япония,город,Ога	Oga,_Akita
осана,республика корея,город,Осан	Osan
ойербах,германия,город  германия,коммуна,Ойербах 	Euerbach
олес-де-бонесвальс,испания,Олеса-де-Бонесвальс	Olesa_de_Bonesvalls
облучье,россия,город,Облучье	Obluchye,_Jewish_Autonomous_Oblast
очерский район,россия,город,Очёрский район	Ochyorsky_District
ондон-де-ласа-ньевес,испания,Ондон-де-лас-Ньевес	El_Fondó_de_les_Neus
оттерберн,великобритания,Оттерберн	Otterburn,_Northumberland
обернберг-на-инн,австрия,Обернберг-на-Инне	Obernberg_am_Inn
оттать,италия,коммуна,Оттати	Ottati
обербромб,германия,коммуна,Обербромбах	Oberbrombach
ольми-каппелл,франция,коммуна,Ольми-Каппелла	Olmi-Cappella
оборнячить,сербия,село,община ад,Оборняча 	Obornjača_(Ada)
оборнячить,сербия,община бачок-топол,населённый пункт,Оборняча 	Obornjača_(Bačka_Topola)
ойбин,германия,коммуна,Ойбин	Oybin
ойльгем,германия,коммуна,Ойльгем	Eulgem
орегон,соединять штат америка,Орегон	Oregon
обьета,франция,коммуна,Обьет	Aubiet
осеол,соединять штат америка,округ,флорида,Осеола 	Osceola_County,_Florida
ояма,япония,поселок,Ояма 	Oyama,_Shizuoka
орешень,болгария,село,ловечский область,Орешене 	Oreshene,_Lovech_Province
остров пасха,чили,остров,Остров Пасхи	Easter_Island
обуэ,франция,коммуна,Обуэ	Auboué
отрить,франция,жер,коммуна,Отрив 	Auterive,_Gers
оспедалетто-д’альпиноло,италия,коммуна,Оспедалетто-д’Альпиноло	Ospedaletto_d'Alpinolo
ото-ан-ож,франция,коммуна,Ото-ан-Ож	Hotot-en-Auge
оберзибенбрунн,австрия,Оберзибенбрунн	Obersiebenbrunn
ординариат румыния,румыния,Ординариат Румынии	Ordinariate_for_Catholics_of_Armenian_Rite_in_Romania
оруский-де-тахунья,испания,Оруско-де-Тахунья	Orusco_de_Tajuña
орт-новый,италия,коммуна,Орта-Нова	Orta_Nova
орать-верди-ду-уэсти,бразилия,муниципалитет,Ору-Верди-ду-Уэсти	Ouro_Verde_do_Oeste
орать-прет,бразилия,город,Ору-Прету	Ouro_Preto
оссаки-вадаль,франция,коммуна,Оссак-Вадаль	Aussac-Vadalle
орнильос-дель-камин,испания,Орнильос-дель-Камино	Hornillos_del_Camino
охать,соединять штат америка,город,Охай	Ojai,_California
оловяннинский район,россия,посёлок,Оловяннинский район	Olovyanninsky_District
оррьюль,франция,коммуна,Оррьюль	Orriule
о-плато,камерун,департамент,О-Плато 	Hauts-Plateaux
огробец,чехия,община,Огробец	Ohrobec
ольфен,германия,город,Ольфен	Olfen
острава,чехия,город,Острава	Ostrava
оберарнбах,германия,коммуна,Оберарнбах	Oberarnbach
октябрьский район,россия,амурский область,Октябрьский район 	Oktyabrsky_District,_Amur_Oblast
обербергиш,германия,район,Обербергиш 	Oberbergischer_Kreis
орьяк,франция,коммуна,ода,Орьяк 	Auriac,_Aude
ольсдорф,австрия,верхний австрия,коммуна,Ольсдорф 	Ohlsdorf
октябрьский,россия,посёлок,волгоградский область,октябрьский район,Октябрьский 	Oktyabrsky,_Oktyabrsky_District,_Volgograd_Oblast
отрадный,украина,запорожский район,Отрадное 	Vidradne,_Zaporizhia_Raion
остфильдерн,германия,город,Остфильдерн	Ostfildern
оберндорф,германия,коммуна,пфальц,Оберндорф 	Oberndorf,_Rhineland-Palatinate
орикола,италия,коммуна,Орикола	Oricola
олбануть,соединять штат америка,нью-йорк,город,Олбани 	Albany,_New_York
остеррад,германия,коммуна,Остерраде	Osterrade
оггау-ама-нойзидлер-зе,австрия,Оггау-ам-Нойзидлер-Зе	Oggau_am_Neusiedler_See
оленегорск,россия,город,Оленегорск	Olenegorsk,_Murmansk_Oblast
останкинский район,россия,Останкинский район	Ostankinsky_District
остров,украина,бусский район,село,Остров 	Ostriv,_Busk_Raion
опан,болгария,община,Опан 	Opan_Municipality
остельсхайм,германия,коммуна,Остельсхайм	Ostelsheim
олдензал,нидерланды,город,Олдензал	Oldenzaal
орлеан,канада,онтарио,Орлеан 	Orleans,_Ontario
обок,джибути,регион,Обок 	Obock_Region
обертойринген,германия,коммуна,Обертойринген	Oberteuringen
олкорн,соединять штат америка,миссисипи,округ,Олкорн 	Alcorn_County,_Mississippi
орт-ди-ателла,италия,город,Орта-ди-Ателла	Orta_di_Atella
от-виньель,франция,коммуна,От-Виньёль	Haute-Vigneulles
обернбург-ама-майн,германия,город,Обернбург-ам-Майн	Obernburg
осси,италия,коммуна,Осси	Ossi,_Sardinia
оберайх,австрия,Оберайх	Oberaich
ончина,италия,коммуна,Ончино	Oncino
оберзехеринг,германия,коммуна,Оберзёхеринг	Obersöchering
оидзуми,япония,посёлок,Оидзуми	Ōizumi,_Gunma
ордунья,испания,город,Ордунья	Orduña-Urduña
остель,германия,коммуна,германия,Остель 	Osteel
октябрьский,белоруссия,гомельский область,Октябрьский 	Akciabrski
ойратсфельд,австрия,Ойратсфельд	Euratsfeld
опфикон,швейцария,город,Опфикон	Opfikon
орсоя,болгария,село,Орсоя	Orsoya
оберхаг,австрия,коммуна,Оберхаг	Oberhaag
олай,колумбия,город,Олая	Olaya,_Antioquia
ордос,китайский народный республика,городской округ,Ордос 	Ordos_City
олимпиу-нороний,бразилия,Олимпиу-Норонья	Olímpio_Noronha
ортигос-дель-монт,испания,Ортигоса-дель-Монте	Ortigosa_del_Monte
охтмерслебен,германия,коммуна,Охтмерслебен	Ochtmersleben
ослип,австрия,коммуна,Ослип	Oslip
озмат,италия,коммуна,Озмате	Osmate
обердинг,германия,коммуна,Обердинг	Oberding
ойо,нигерия,город,штат,Ойо 	Oyo_State
оленинский район,россия,Оленинский район	Oleninsky_District
оркахуэло-де-ла-сьерра,испания,муниципалитет,Оркахуэло-де-ла-Сьерра	Horcajuelo_de_la_Sierra
олон,франция,верхний пиренеи,коммуна,Олон 	Aulon,_Hautes-Pyrénées
обжицкий,польша,Обжицко	Obrzycko
огавар,япония,посёлок,Огавара	Ōgawara,_Miyagi
оверэйсседать,нидерланды,провинция,Оверэйссел	Overijssel
оливейра-ди-фатима,бразилия,Оливейра-ди-Фатима	Oliveira_de_Fátima
оспедалетто-эуганео,италия,коммуна,Оспедалетто-Эуганео	Ospedaletto_Euganeo
оммен,нидерланды,община,Оммен	Ommen
обяляй,литва,город,Обяляй	Obeliai
одесский район,россия,село,Одесский район	Odessky_District
оберау,германия,коммуна,Оберау	Oberau
озаринец,украина,село,Озаринцы	Ozaryntsi
оливез,франция,коммуна,Оливезе	Olivese
орор,соединять штат америка,город,миннесота,Орора 	Aurora,_Minnesota
оренвиль,франция,коммуна,Оренвиль	Orainville
оберштауфен,германия,коммуна,Оберштауфен	Oberstaufen
оледжо,италия,коммуна,Оледжо	Oleggio
оберлин,соединять штат америка,город,Оберлин	Oberlin,_Ohio
окинский район,россия,село,Окинский район	Okinsky_District
олбануть,соединять штат америка,округ,вайоминг,Олбани 	Albany_County,_Wyoming
остерби,германия,коммуна,рендсбург-эккернферде,Остерби 	Osterby,_Rendsburg-Eckernförde
оскири,италия,коммуна,Оскири	Oschiri
ортипорио,франция,коммуна,Ортипорио	Ortiporio
оттенталь,австрия,коммуна,Оттенталь	Ottenthal
оммерея,франция,коммуна,Оммереи	Ommeray
осеново,болгария,благоевградский область,Осеново 	Osenovo,_Blagoevgrad_Province
ожевиллер,франция,коммуна,Ожевиллер	Ogéviller
о’брайен,соединять штат америка,округ,айова,О’Брайен 	O'Brien_County,_Iowa
окиносить,япония,Окиносима	Okinoshima,_Shimane
олд-кроу,канада,населённый пункт,Олд-Кроу	Old_Crow,_Yukon
осентехо,испания,Осентехо	Ocentejo
орать-ан-ратья,франция,коммуна,Ори-ан-Ратье	Oris-en-Rattier
обервайс,германия,коммуна,Обервайс	Oberweis,_Germany
обель,бельгия,коммуна,Обель	Aubel
оксфорд,соединять штат америка,округ,мэн,Оксфорд 	Oxford_County,_Maine
олецкий,польша,город,Олецко	Olecko
осон,франция,коммуна,округ тулуза,Осон 	Aussonne
острув-любельский,польша,город,Острув-Любельский	Ostrów_Lubelski
острамондра,германия,коммуна,Острамондра	Ostramondra
охлювец,болгария,село,Охлювец	Ohlyuvets
обинья,франция,коммуна,Обинья	Aubignas
оберпфраммерн,германия,община,Оберпфраммерн	Oberpframmern
овинген,германия,коммуна,Овинген	Owingen
осен,франция,коммуна,Осен 	Ausseing
орвиль,франция,коммуна,эндр,Орвиль 	Orville,_Indre
оттербах,германия,коммуна,рейнланд-пфальц,Оттербах 	Otterbach
оберлашайд,германия,коммуна,Оберлашайд	Oberlascheid
орньяк-сюр-везер,франция,коммуна,Орньяк-сюр-Везер	Orgnac-sur-Vézère
онифери,италия,коммуна,Онифери	Oniferi
оппин,германия,деревня,Оппин	Oppin
охтруп,германия,город,Охтруп	Ochtrup
огродзенец,польша,гмина,Огродзенец 	Gmina_Ogrodzieniec
оришимин,бразилия,муниципалитет,Оришимина	Oriximiná
оштав,болгария,село,Оштава	Oshtava
обергебра,германия,посёлок,Обергебра	Obergebra
ориндж-уолк,белиз,округ,город,Ориндж-Уолк 	Orange_Walk_District
опи,италия,коммуна,Опи	Opi,_Abruzzo
озанс-монтестрюк,франция,коммуна,Озанс-Монтестрюк	Ozenx-Montestrucq
ольбендорф,австрия,коммуна,Ольбендорф	Olbendorf
оксана,франция,коммуна,Оксан	Auxant
острый-ветер,италия,коммуна,Остра-Ветере	Ostra_Vetere
окра,италия,коммуна,Окре	Ocre
одо,франция,коммуна,Одо 	Audaux
ольдислебен,германия,коммуна,Ольдислебен	Oldisleben
оберрота,германия,коммуна,баден-вюртемберг,Оберрот 	Oberrot
огилви,соединять штат америка,город,миннесота,Огилви 	Ogilvie,_Minnesota
ожарув,польша,Ожарув	Ożarów
окс-дюрес,франция,коммуна,Оксе-Дюрес	Auxey-Duresses
осос,франция,коммуна,Осос	Aussos
остшешувский повенок,польша,город,Остшешувский повят	Ostrzeszów_County
овиндоль,италия,коммуна,Овиндоли	Ovindoli
о,франция,коммуна,атлантический пиренеи,О 	Haux,_Pyrénées-Atlantiques
опылченский,болгария,село,Опылченско	Opulchensko
оспиталь-ди-кадор,италия,коммуна,Оспитале-ди-Кадоре	Ospitale_di_Cadore
ос-де-балагер,испания,Ос-де-Балагер	Os_de_Balaguer
о’брайенсбридж,ирландия,деревня,О’Брайенсбридж	O'Brien's_Bridge
обиньян,франция,коммуна,Обиньян	Aubignan
оро,папуа — новый гвинея,провинция,Оро 	Oro_Province
отреп,франция,коммуна,Отреп	Autreppes
оля-э-ренод,франция,коммуна,Оль-э-Ренод	Ols-et-Rinhodes
орибо,франция,коммуна,Орибо	Auribeau
овалье,чили,город,Овалье	Ovalle
орн,франция,коммуна,Орне	Ornex
осакаровский район,казахстан,посёлок,Осакаровский район	Osakarov_District
остроэ,германия,коммуна,Остроэ	Ostrohe
орт,италия,коммуна,Орте	Orte
олесницкий повенок,польша,город,Олесницкий повят	Oleśnica_County
оберхамб,германия,коммуна,Оберхамбах	Oberhambach
оберриксинген,германия,город,Оберриксинген	Oberriexingen
ораньестад,нидерланды,синт-эстатиус,Ораньестад 	Oranjestad,_Sint_Eustatius
оберреттенбах,австрия,коммуна,Оберреттенбах	Oberrettenbach
обердорф,австрия,бургенланд,коммуна,Обердорф 	Oberdorf_im_Burgenland
они,германия,коммуна,германия,Оне 	Ohne
ориндж,соединять штат америка,калифорния,город,Ориндж 	Orange,_California
осеол,соединять штат америка,арканзас,Осеола 	Osceola,_Arkansas
олтеница,румыния,город,Олтеница	Oltenița
оплетень,болгария,село,Оплетня	Opletnya
оттенхефен,германия,коммуна,шварцвальд,Оттенхёфен 	Ottenhöfen_im_Schwarzwald
оффенбах-хундхайм,германия,коммуна,Оффенбах-Хундхайм	Offenbach-Hundheim
орхид,соединять штат америка,флорида,Орхид 	Orchid,_Florida
ортигейр,испания,испания,Ортигейра 	Ortigueira
оушен-ридж,соединять штат америка,флорида,Оушен-Ридж 	Ocean_Ridge,_Florida
орлов-дол,болгария,село,Орлов-Дол	Orlov_dol
озеро,франция,коммуна,Озер	Auzers
обершать,германия,коммуна,Обершёна	Oberschöna
оберварт,австрия,округ,Оберварт 	Oberwart_District
орослань,венгрия,город,Орослань	Oroszlány
ольдерсбек,германия,коммуна,Ольдерсбек	Oldersbek
окар,пакистан,город,Окара 	Okara,_Pakistan
ортигос-де-пестаньо,испания,Ортигоса-де-Пестаньо	Ortigosa_de_Pestaño
онтангас,испания,Онтангас	Hontangas
орпи,испания,населённый пункт,Орпи	Orpí
остров зич,россия,Острова Зичи	Zichy_Land
отмон,франция,коммуна,город,Отмон 	Hautmont
оттенбах,германия,вюртемберг,община,Оттенбах 	Ottenbach,_Baden-Württemberg
олимпия,соединять штат америка,вашингтон,город,Олимпия 	Olympia,_Washington
орловский район,россия,орловский область,город,Орловский район 	Orlovsky_District,_Oryol_Oblast
оттерсхайм,германия,коммуна,Оттерсхайм	Ottersheim
ормилий,греция,город,Ормилия	Ormylia
онеонт,соединять штат америка,город,Онеонта	Oneonta,_New_York
обервайлер-тифенбах,германия,коммуна,Обервайлер-Тифенбах	Oberweiler-Tiefenbach
оссо-де-синка,испания,муниципалитет,Оссо-де-Синка	Osso_de_Cinca
отон,бельгия,бельгия,коммуна,Отон 	Hotton
османштедт,германия,коммуна,Османштедт	Oßmannstedt
отрепьер,франция,коммуна,Отрепьер	Autrepierre
ориньоль,франция,коммуна,Ориньоль	Orignolles
одавар,япония,город,Одавара	Odawara
оптевоз,франция,коммуна,Оптевоз	Optevoz
он,франция,жер,коммуна,Он 	Homps,_Gers
орозей,италия,коммуна,Орозеи	Orosei
ольховатский район,россия,Ольховатский район	Olkhovatsky_District
оэвиль,франция,коммуна,Оэвиль	Hoéville
от-санага,камерун,департамент,От-Санага 	Haute-Sanaga
ошогбо,нигерия,город,Ошогбо	Osogbo
оверенок,россия,посёлок,Оверята	Overyata
осташков,россия,город,Осташков	Ostashkov
о-ле-кромарь,франция,коммуна,О-ле-Кромари	Aulx-lès-Cromary
оруэсти,бразилия,муниципалитет,Оруэсти	Ouroeste
орьенталь,мексика,муниципалитет,Орьенталь 	Oriental_(municipality)
обершайдвайлер,германия,коммуна,Обершайдвайлер	Oberscheidweiler
ойшайд,германия,коммуна,Ойшайд	Euscheid
оштра-лук,босния и герцеговина,община,Оштра-Лука 	Oštra_Luka
осойци,босния и герцеговина,населенный пункт,Осойци	Osojci
обернберг-на-бреннер,австрия,коммуна,Обернберг-на-Бреннере	Obernberg_am_Brenner
ориндж-парк,соединять штат америка,флорида,Ориндж-Парк 	Orange_Park,_Florida
олесненский повенок,польша,Олесненский повят	Olesno_County
ольберсдорф,германия,коммуна,Ольберсдорф	Olbersdorf
оливетта-сан-микеле,италия,коммуна,Оливетта-Сан-Микеле	Olivetta_San_Michele
остервальд,германия,коммуна,Остервальд	Osterwald
олд-оттава-саут,канада,Олд-Оттава-Саут	Old_Ottawa_South
отаглый,азербайджан,Отаглы	Otaqlı
онвиль,франция,коммуна,Онвиль	Onville
обершютцен,австрия,коммуна,Обершютцен	Oberschützen
онтанарес-де-эресма,испания,Онтанарес-де-Эресма	Hontanares_de_Eresma
обер-хильберсхайм,германия,коммуна,Обер-Хильберсхайм	Ober-Hilbersheim
ореро,италия,коммуна,Ореро	Orero
орукун,австралия,графство,район,Орукун 	Shire_of_Aurukun
октябрьский район,россия,волгоградский область,Октябрьский район 	Oktyabrsky_District,_Volgograd_Oblast
оричевский район,россия,посёлок,Оричевский район	Orichevsky_District
орначуэлос,испания,населённый пункт,Орначуэлос	Hornachuelos
орадур-сюр-глан,франция,коммуна,Орадур-сюр-Глан	Oradour-sur-Glane_(commune)
овоштарци,болгария,село,Овоштарци	Ovoshtartsi
омервиль,франция,муниципалитет,Омервиль	Omerville
онис,испания,муниципалитет,Онис	Onís
остерхефер,германия,коммуна,Остерхефер	Osterhever
оберзюльцен,германия,коммуна,Оберзюльцен	Obersülzen
оберхельфеншвиль,швейцария,коммуна,Оберхельфеншвиль	Oberhelfenschwil
олула-де-кастро,испания,населённый пункт,Олула-де-Кастро	Olula_de_Castro
отмухув,польша,гмина,Отмухув 	Gmina_Otmuchów
оберальбена,германия,коммуна,Оберальбен	Oberalben
от-иль,франция,муниципалитет,От-Иль	Haute-Isle
ольхонский район,россия,село,Ольхонский район	Olkhonsky_District
обернцен,германия,коммуна,Обернцен	Obernzenn
олецкий повенок,польша,город,Олецкий повят	Olecko_County
осуиго,соединять штат америка,нью-йорк,Осуиго 	Oswego,_New_York
осюрюк,франция,коммуна,Осюрюк	Aussurucq
ошель,франция,франция,коммуна,Ошель 	Auchel
окрос,перо,провинция,Окрос 	Ocros_Province
олакур,франция,коммуна,Олакур	Holacourt
обервалльмен,германия,коммуна,Обервалльменах	Oberwallmenach
он,франция,коммуна,арденны,Он 	Osnes
олава,польша,город,Олава	Oława
оленица,россия,село,Оленица 	Olenitsa
остров бейнбридж,соединять штат америка,Остров Бейнбридж	Bainbridge_Island,_Washington
острув,польша,деревня,мышкувский повенок,Острув 	Ostrów,_Myszków_County
ока-ридж,соединять штат америка,город,Ок-Ридж	Oak_Ridge,_Tennessee
овьедо,испания,район,комарка,Овьедо 	Oviedo_(comarca)
отеро,соединять штат америка,округ,нью-мексико,Отеро 	Otero_County,_New_Mexico
оберкаппель,австрия,Оберкаппель	Oberkappel
орист,испания,Ориста	Oristà
оберталь,швейцария,коммуна,берн,Оберталь 	Oberthal,_Switzerland
окар,пакистан,округ,город,Окара 	Okara_District
обернхольц,германия,коммуна,Обернхольц	Obernholz
ортонвилл,соединять штат америка,город,миннесота,Ортонвилл 	Ortonville,_Minnesota
ордон,италия,коммуна,Ордона	Ordona
одзений,италия,коммуна,Одзенья	Ozegna
однадатт,австралия,город,Однадатта	Oodnadatta
онондаг,соединять штат америка,нью-йорк,округ,Онондага 	Onondaga_County,_New_York
оваджык,турция,город,Оваджык	Ovacık,_Dersim
ольшина,польша,город,Ольшина	Olszyna
ольстер,ирландия,Ольстер	Ulster
ольнон,франция,коммуна,Ольнон	Holnon
оронс,франция,коммуна,буш-дю-рон,Оронс 	Aurons
оннюд-ци,китайский народный республика,Оннюд-Ци	Ongniud_Banner
ороландий,бразилия,Ороландия	Ourolândia
осер-де-эбро,испания,Осера-де-Эбро	Osera_de_Ebro
оберхюниген,швейцария,коммуна,Оберхюниген	Oberhünigen
орвието,италия,город,Орвието	Orvieto
оряхово,болгария,город,Оряхово	Oryahovo
ольмо-аль-брембо,италия,коммуна,Ольмо-аль-Брембо	Olmo_al_Brembo
оннен,франция,коммуна,Оннен	Onnaing
ольюль,франция,коммуна,Ольюль	Ollioules
оберербах,германия,коммуна,монтабаур,Оберербах 	Obererbach,_Westerwaldkreis
озьель,франция,коммуна,Озьель	Auzielle
осечный,польша,великопольский воеводство,город,Осечна 	Osieczna
оконек,польша,Оконек	Okonek
обоянский район,россия,город,Обоянский район	Oboyansky_District
оппург,германия,коммуна,Оппург	Oppurg
онкал,испания,муниципалитет,Онкала	Oncala
ольвайлер,германия,коммуна,Ольвайлер	Ohlweiler
олье-д’агуа-ду-пиауи,бразилия,муниципалитет,Олью-д’Агуа-ду-Пиауи	Olho_d'Água_do_Piauí
охус,швеция,город,Охус	Åhus
орешарь,болгария,село,Орешари	Oreshari
оссо-де-сио,испания,Оссо-де-Сио	Ossó_de_Sió
оо,франция,коммуна,Оо 	Oô
орли,франция,франция,коммуна,Орли 	Orly
ошкош,соединять штат америка,Ошкош	Oshkosh,_Wisconsin
околиит,болгария,село,Околиите	Okoliyte
оля-куртиль,франция,коммуна,Оли-Куртиль	Osly-Courtil
омер,израиль,населенный пункт,Омер 	Omer,_Israel
ольялва,португалия,Ольялву	Olhalvo
ортегаль,испания,район,комарка,Ортегаль 	Ortegal
одерн,польша,деревня,Одерне	Oderne
оричевский район,россия,Оричевский район	Orichevsky_District
окичоби,соединять штат америка,округ,флорида,Окичоби 	Okeechobee_County,_Florida
они,швейцария,коммуна,женева,Оне 	Onex,_Switzerland
оборник,польша,Оборники	Oborniki
осен,франция,коммуна,Осён	Ossun
опатув,польша,гмина,опатувский повенок,Опатув 	Gmina_Opatów,_Świętokrzyskie_Voivodeship
ота,португалия,район,аленкер,Ота 	Ota_(Alenquer)
отрикур,франция,коммуна,Отрикур	Autricourt
остзан,нидерланды,община,Остзан	Oostzaan
о-барко-де-вальдеоррас,испания,О-Барко-де-Вальдеоррас	O_Barco_de_Valdeorras
огема,соединять штат америка,город,миннесота,Огема 	Ogema,_Minnesota
обермумпф,швейцария,коммуна,Обермумпф	Obermumpf
одрюик,франция,коммуна,Одрюик	Audruicq
октябрьский район,россия,район,пермский край,Октябрьский район 	Oktyabrsky_District,_Perm_Krai
особница,польша,село,Особница	Osobnica
оргас,испания,муниципалитет,Оргас	Orgaz
онежский район,россия,город,Онежский район	Onezhsky_District
онкан,великобритания,посёлок,Онкан	Onchan
отеро-де-бодас,испания,Отеро-де-Бодас	Otero_de_Bodas
ольховский район,россия,Ольховский район	Olkhovsky_District
орландо,соединять штат америка,флорида,Орландо 	Orlando,_Florida
оберлиенц,австрия,коммуна,Оберлиенц	Oberlienz
опатув,польша,Опатув	Opatów
обермошель,германия,город,Обермошель	Obermoschel
оберморшвир,франция,коммуна,Оберморшвир	Obermorschwihr
олот,испания,Олот	Olot
олта,турция,город,Олту	Oltu
отрикалывать,италия,коммуна,Отриколи	Otricoli
одровонж,польша,малопольский воеводство,Одровонж 	Odrowąż,_Lesser_Poland_Voivodeship
оберванг,австрия,коммуна,Оберванг	Oberwang
оборишта,болгария,село,пазарджикский область,Обориште 	Oborishte
обривать,франция,коммуна,Обрив	Aubrives
острандер,соединять штат америка,город,миннесота,Острандер 	Ostrander,_Minnesota
островной,россия,село,Островной	Ostrovnoy,_Murmansk_Oblast
осеол,соединять штат америка,округ,айова,Осеола 	Osceola_County,_Iowa
очаковский район,украина,Очаковский район	Ochakiv_Raion
оберхаузен,германия,пайсенберг,коммуна,Оберхаузен 	Oberhausen,_Weilheim-Schongau
оберирзен,германия,коммуна,Оберирзен	Oberirsen
остерхофен,германия,город,Остерхофен	Osterhofen
отрекур-э-пуррон,франция,коммуна,Отрекур-э-Пуррон	Autrecourt-et-Pourron
оушенсайд,соединять штат америка,калифорния,Оушенсайд 	Oceanside,_California
онтанар,испания,Онтанар	Hontanar
ош,франция,коммуна,Оше	Ochey
оберросбах,германия,коммуна,Оберросбах	Oberroßbach
они,франция,верхний сона,коммуна,Оне 	Onay
остервиц,австрия,коммуна,Остервиц	Osterwitz
отегно-батыр,казахстан,посёлок,Отеген-Батыр	Otegen_Batyr
они-ле-шато,франция,коммуна,Оне-ле-Шато	Onet-le-Château
ошторинан,иран,Ошторинан	Oshtorinan
оснабрюк,германия,город,Оснабрюк	Osnabrück
октябрьск,россия,самарский область,город,Октябрьск 	Oktyabrsk
обердорф-ама-хохег,австрия,коммуна,Обердорф-ам-Хохег	Oberdorf_am_Hochegg
оруро,боливия,столица,Оруро	Oruro,_Bolivia
обербодница,германия,коммуна,Обербодниц	Oberbodnitz
оканоган,соединять штат америка,вашингтон,округ,Оканоган 	Okanogan_County,_Washington
озуэстереть,великобритания,город,Озуэстри	Oswestry
окно-муреш,румыния,город,Окна-Муреш	Ocna_Mureș
обуховый,россия,посёлок,поселок городской тип,Обухово 	Obukhovo,_Noginsky_District,_Moscow_Oblast
обь,россия,город,Обь 	Ob,_Russia
оканье,колумбия,колумбия,город,Оканья 	Ocaña,_Norte_de_Santander
ольштадт,германия,коммуна,Ольштадт	Ohlstadt
обривать-ан-руаян,франция,коммуна,Обрив-ан-Руаян	Auberives-en-Royans
остоичев,сербия,село,Остоичево	Ostojićevo
ольмето,франция,коммуна,Ольмето	Olmeto
оберндорф,германия,ост,коммуна,Оберндорф 	Oberndorf,_Lower_Saxony
огняново,болгария,село,благоевградский область,Огняново 	Ognyanovo,_Blagoevgrad_Province
орбек,франция,коммуна,Орбек	Orbec
опочненский повенок,польша,город,Опочненский повят	Opoczno_County
отоинеппа,япония,село,Отоинеппу	Otoineppu,_Hokkaido
олбануть,соединять штат америка,город,джорджия,Олбани 	Albany,_Georgia
олле,франция,мерт  мозель,коммуна,Олле 	Olley
оравица,румыния,город,Оравица 	Oravița
охленберг,швейцария,коммуна,Охленберг	Ochlenberg
ожер,франция,коммуна,Ожер	Augères
обвуа,франция,коммуна,Обвуа	Aubevoye
омутинский район,россия,Омутинский район	Omutinsky_District
овильо,италия,коммуна,Овильо	Oviglio
одиенна,кот-д’ивуар,город,Одиенне	Odienné
облученский район,россия,город,Облученский район	Obluchensky_District
отвиль-лонес,франция,коммуна,Отвиль-Лонес	Hauteville-Lompnes
островной,россия,чукотский автономный округ,Островное 	Ostrovnoye,_Chukotka_Autonomous_Okrug
ориуэла-дель-тремедаль,испания,Ориуэла-дель-Тремедаль	Orihuela_del_Tremedal
оклахома-сити,соединять штат америка,Оклахома-Сити	Oklahoma_City
орнавассо,италия,коммуна,Орнавассо	Ornavasso
омден,германия,коммуна,Омден	Ohmden
очандьяно,испания,муниципалитет,Очандьяно	Otxandio
орденес,испания,район,комарка,Орденес 	Ordes_(comarca)
орать,эстония,кохтла-ярве,Ору 	Oru,_Kohtla-Järve
олива,испания,испания,муниципалитет,Олива 	Oliva
оконешниковский район,россия,посёлок,Оконешниковский район	Okoneshnikovsky_District
орошхаз,венгрия,город,Орошхаза	Orosháza
оберхозенбах,германия,коммуна,Оберхозенбах	Oberhosenbach
обердюренбах,германия,коммуна,Обердюренбах	Oberdürenbach
обергренинген,германия,коммуна,Обергрёнинген	Obergröningen
оряхово,болгария,село,Оряхово 	Oryahovo,_Haskovo_Province
овер-сюр-уаз,франция,муниципалитет,Овер-сюр-Уаз	Auvers-sur-Oise
остфлакка,нидерланды,община,Остфлакке	Oostflakkee
ольмильос-де-муньо,испания,Ольмильос-де-Муньо	Olmillos_de_Muñó
оливейра-ду-мондега,португалия,Оливейра-ду-Мондегу	Oliveira_do_Mondego_e_Travanca_do_Mondego
олавский повенок,польша,город,Олавский повят	Oława_County
олдем,соединять штат америка,округ,техас,Олдем 	Oldham_County,_Texas
оризонтина,бразилия,муниципалитет,Оризонтина	Horizontina
оржиб,франция,коммуна,Оржибе	Orgibet
оттильо,италия,коммуна,Оттильо	Ottiglio
ориндж-уолк,белиз,город,Ориндж-Уолк	Orange_Walk_Town
ортон,италия,город,Ортона	Ortona
орчать-пизать,италия,коммуна,Орчано-Пизано	Orciano_Pisano
оженный,польша,село,Оженна	Ożenna
оссийон,франция,коммуна,Оссийон	Aussillon
огой,болгария,село,Огоя	Ogoya
ортакей,турция,город,аксарай,Ортакёй 	Ortaköy,_Aksaray
оттонвиль,франция,коммуна,Оттонвиль	Ottonville
олон,франция,крез,коммуна,Олон 	Aulon,_Creuse
омбелл-мпоко,центральноафриканский республика,город,Омбелла-Мпоко	Ombella-M'Poko
оденталь,германия,коммуна,Оденталь	Odenthal
олни,соединять штат америка,город,техас,Олни 	Olney,_Texas
ойокасеро,испания,муниципалитет,Ойокасеро	Hoyocasero
орявчик,украина,село,Орявчик	Oryavchyk
ойос-де-мигель-муньос,испания,Ойос-де-Мигель-Муньос	Hoyos_de_Miguel_Muñoz
осметс,франция,коммуна,Осметс	Osmets
одоровци,болгария,село,Одоровци	Odorovtsi
окойоакак,мексика,город,Окойоакак	Ocoyoacac
одивелаш,португалия,район,Одивелаш 	Odivelas_(parish)
обен,франция,коммуна,кот-д’ор,Обен 	Aubaine,_Côte-d'Or
орля,франция,коммуна,Орлю	Orlu,_Ariège
онтория-дель-пинар,испания,Онтория-дель-Пинар	Hontoria_del_Pinar
отрадный,россия,город,Отрадное 	Otradnoye,_Kirovsky_District,_Leningrad_Oblast
ознобишин,россия,деревня,владимирский область,Ознобишино 	Oznobishino,_Vladimir_Oblast
остан,италия,коммуна,Остана	Ostana
охитоса-де-санта-лусия,мексика,Охитос-де-Санта-Лусия	Ojitos_de_Santa_Lucía
о-дю-тот-шато-ламбер,франция,коммуна,О-дю-Тем-Шато-Ламбер	Haut-du-Them-Château-Lambert
отен,франция,город,Отён	Autun
обер-костенц,германия,коммуна,Обер-Костенц	Ober_Kostenz
остров спафарьев,россия,остров,Остров Спафарьева	Spafaryev_Islands
онать,италия,коммуна,Онано	Onano
отепя,эстония,город,Отепя	Otepää
острикур,франция,коммуна,Острикур	Ostricourt
омусати,намибия,город,Омусати	Omusati_Region
оленинский район,россия,посёлок,Оленинский район	Oleninsky_District
онтеньенте,испания,муниципалитет,Онтеньенте	Ontinyent
оцберг,германия,коммуна,Оцберг	Otzberg
оберштауфенбах,германия,коммуна,Оберштауфенбах	Oberstaufenbach
ортенберг,германия,коммуна,баден,Ортенберг 	Ortenberg,_Baden-Württemberg
ольмос-де-охед,испания,населённый пункт,Ольмос-де-Охеда	Olmos_de_Ojeda
олеак-дебат,франция,коммуна,Олеак-Дебат	Oléac-Debat
охинага,мексика,муниципалитет,город,Охинага 	Ojinaga_Municipality
оксенхаузен,германия,город,Оксенхаузен	Ochsenhausen
оконто-фолс,соединять штат америка,город,Оконто-Фолс	Oconto_Falls,_Wisconsin
оберфелль,германия,коммуна,Оберфелль	Oberfell
октябрьский район,россия,село,еврейский автономный область,Октябрьский район 	Oktyabrsky_District,_Jewish_Autonomous_Oblast
обтирать-сюр-дрон,франция,коммуна,Обтер-сюр-Дрон	Aubeterre-sur-Dronne
обермархталь,германия,коммуна,Обермархталь	Obermarchtal
ойонна,франция,город,Ойонна	Oyonnax
орлов,чехия,город,Орлова 	Orlová
оллерсдорф,австрия,бургенланд,Оллерсдорф 	Ollersdorf_im_Burgenland
ормскирк,великобритания,город,Ормскирк	Ormskirk
овручский район,украина,Овручский район	Ovruch_Raion
обштайг,австрия,коммуна,Обштайг	Obsteig
оберфихт,германия,город,Оберфихтах	Oberviechtach
оссаго-лодиджано,италия,коммуна,Оссаго-Лодиджано	Ossago_Lodigiano
оит,япония,префектура,город,Оита 	Ōita_Prefecture
орб,испания,населённый пункт,Орба	Orba,_Alicante
оренса,испания,провинция,Оренсе 	Province_of_Ourense
орсфельд,германия,коммуна,Орсфельд	Orsfeld
остров гриль,россия,остров,Остров Грили	Greely_Island
осрблье,словакия,деревня,Осрблье	Osrblie
оверат,германия,город,Оверат	Overath
оберштадион,германия,коммуна,Оберштадион	Oberstadion
ольгинский район,россия,район,Ольгинский район	Olginsky_District
охангвен,намибия,город,Охангвена	Ohangwena_Region
обинья-ан-ланнуа,франция,коммуна,Обиньи-ан-Ланнуа	Aubigny-en-Laonnois
оберталь,германия,коммуна,саар,Оберталь 	Oberthal,_Saarland
орнезан,франция,коммуна,Орнезан	Ornézan
орбан,франция,коммуна,Орбан 	Orban,_Tarn
оджон-кон-санто-стефано,италия,коммуна,Оджона-кон-Санто-Стефано	Oggiona_con_Santo_Stefano
озеры,россия,город,Озёры	Ozyory,_Moscow_Oblast
олива-джесси,италия,Олива-Джесси	Oliva_Gessi
обервенинген,швейцария,коммуна,Обервенинген	Oberweningen
осеново,болгария,село,благоевградский область,Осеново 	Osenovo,_Blagoevgrad_Province
омуа,франция,шер,коммуна,Омуа 	Osmoy,_Cher
область залив сан-франциско,соединять штат америка,Область залива Сан-Франциско	San_Francisco_Bay_Area
орер,испания,муниципалитет,Орера	Orera
овидиу,румыния,город,Овидиу	Ovidiu
оттинг,германия,коммуна,Оттинг	Otting
олекминск,россия,город,Олёкминск	Olyokminsk
осеновлага,болгария,село,Осеновлаг	Osenovlag
оспиталет-де-льобрегат,испания,город,Оспиталет-де-Льобрегат	L'Hospitalet_de_Llobregat
омань,франция,коммуна,Омань	Aumagne
олькуш,польша,гмина,Олькуш 	Gmina_Olkusz
омбуй,габон,город,Омбуе	Omboué
орлеанс,соединять штат америка,нью-йорк,округ,Орлеанс 	Orleans_County,_New_York
орменан,франция,коммуна,Орменан	Ormenans
орнбау,германия,город,Орнбау	Ornbau
озимек,польша,гмина,Озимек 	Gmina_Ozimek
орри-ла-виль,франция,город,Орри-ла-Виль	Orry-la-Ville
обтирать,франция,коммуна,эндр,Обтер 	Obterre
обернбрайт,германия,коммуна,Обернбрайт	Obernbreit
орко-фельин,италия,коммуна,Орко-Фельино	Orco_Feglino
ольер,франция,коммуна,Ольер	Ollières
опфенбах,германия,коммуна,Опфенбах	Opfenbach
обернхайм-кирхенарнбах,германия,коммуна,Обернхайм-Кирхенарнбах	Obernheim-Kirchenarnbach
ольсбрюккен,германия,коммуна,Ольсбрюккен	Olsbrücken
олений губа,россия,населённый пункт,Оленья Губа	Olenya_Guba_(rural_locality)
оберербах,германия,коммуна,вестервальд,Оберербах 	Obererbach
очаково-матвеевский,россия,Очаково-Матвеевское	Ochakovo-Matveyevskoye_District
одон,испания,испания,муниципалитет,Одон 	Odón
офтеринг,австрия,коммуна,Офтеринг	Oftering
оберхаузен,германия,коммуна,наэ,Оберхаузен 	Oberhausen_an_der_Nahe
ольцай,италия,коммуна,Ольцаи	Olzai
остунь,италия,коммуна,Остуни	Ostuni
обен-лезть-альпы,франция,коммуна,Обена-лез-Альп	Aubenas-les-Alpes
овшлаг,германия,коммуна,Овшлаг	Owschlag
осенкс,франция,коммуна,Осенкс	Ossenx
обербург,швейцария,коммуна,берн,Обербург 	Oberburg
орденес,испания,муниципалитет,Орденес	Ordes
отельфинген,швейцария,коммуна,Отельфинген	Otelfingen
ольбернхау,германия,город,Ольбернхау	Olbernhau
ожикур,франция,коммуна,Ожикур	Augicourt
октябрьский район,белоруссия,минск,Октябрьский район 	Kastrychnitski_District
омутнинский район,россия,город,Омутнинский район	Omutninsky_District
осейкис,соединять штат америка,город,миннесота,Осейкис 	Osakis,_Minnesota
одолевать-вода,чехия,город,Одолена-Вода	Odolena_Voda
отвиль-ле-дижон,франция,коммуна,Отвиль-ле-Дижон	Hauteville-lès-Dijon
орио-литта,италия,коммуна,Орио-Литта	Orio_Litta
обербальм,швейцария,коммуна,Обербальм	Oberbalm
острава-город,чехия,Острава-город	Ostrava-City_District
отвиль,франция,коммуна,арденны,Отвиль 	Hauteville,_Ardennes
отрадный,россия,район,район москва,Отрадное 	Otradnoye_District
ориндж,соединять штат америка,округ,техас,Ориндж 	Orange_County,_Texas
осенсбрюк,швеция,населённый пункт,Осенсбрюк	Åsensbruk
оккьеппо-инфериора,италия,коммуна,Оккьеппо-Инфериоре	Occhieppo_Inferiore
ольета,испания,муниципалитет,Ольете	Oliete
ольван,испания,муниципалитет,Ольван	Olvan
отвильер,франция,коммуна,Отвильер	Hautvillers
отвоцк,польша,город,Отвоцк	Otwock
обериккельсхайм,германия,коммуна,Обериккельсхайм	Oberickelsheim
ориндж,австралия,австралия,город,Ориндж 	Orange,_New_South_Wales
октябрьский район,россия,еврейский автономный область,Октябрьский район 	Oktyabrsky_District,_Jewish_Autonomous_Oblast
оттерсвайер,германия,коммуна,Оттерсвайер	Ottersweier
отвоцкий повенок,польша,город,Отвоцкий повят	Otwock_County
остров льюис,великобритания,регион,Остров Льюис 	Lewis
ононский район,россия,село,Ононский район	Ononsky_District
оттендорф-ан-дер-ритшайн,австрия,коммуна,Оттендорф-ан-дер-Ритшайн	Ottendorf_an_der_Rittschein
обоянь,россия,город,Обоянь	Oboyan
ор,франция,коммуна,арденны,Ор 	Aure,_Ardennes
окно,украина,ивано-франковский область,село,Окно 	Vikno
остеркаппельн,германия,коммуна,Остеркаппельн	Ostercappeln
озио-сотто,италия,город,Озио-Сотто	Osio_Sotto
омсукчанский городской округ,россия,посёлок,Омсукчанский городской округ	Omsukchansky_District
оберкирха,швейцария,коммуна,люцерн,Оберкирх 	Oberkirch,_Switzerland
олива,франция,город,Оливе	Olivet,_Loiret
опава,чехия,город,Опава	Opava
оз,франция,коммуна,Озе	Auzet
оренбургский район,россия,Оренбургский район	Orenburgsky_District
ороноко,соединять штат америка,город,миннесота,Ороноко 	Oronoco,_Minnesota
охрить,ирландия,уиклоу,Охрим 	Aughrim,_County_Wicklow
осерен-риварет,франция,коммуна,Осерен-Риварет	Osserain-Rivareyte
одельцхаузен,германия,коммуна,Одельцхаузен	Odelzhausen
остер,италия,муниципалитет,коммуна,Остра 	Ostra,_Marche
обонн,франция,муниципалитет,Обонн	Eaubonne
освенцим,польша,город,Освенцим 	Oświęcim
остернинбург,германия,коммуна,Остернинбург	Osternienburg
овельгенне,германия,коммуна,Овельгённе	Ovelgönne
орда,турция,ил,город,Орду 	Ordu_Province
ормара,пакистан,Ормара	Ormara
октябрьский,россия,архангельский область,посёлок,Октябрьский 	Oktyabrsky,_Arkhangelsk_Oblast
оньевиль,франция,коммуна,Оньевиль	Ognéville
опач,молдавия,село,Опач	Opaci
обилич,республика косово,город,Обилич 	Obilić
осел,швеция,коммуна,Оселе 	Åsele_Municipality
оберпиршайд,германия,коммуна,Оберпиршайд	Oberpierscheid
оберриден,германия,швабия,коммуна,Оберриден 	Oberrieden,_Bavaria
ойя-де-буньоль,испания,район,Ойя-де-Буньоль	Hoya_de_Buñol
омуртаг,болгария,город,Омуртаг 	Omurtag_(town)
ольджат-мольгор,италия,коммуна,Ольджате-Мольгора	Olgiate_Molgora
обервиль-они-зимменталь,швейцария,коммуна,Обервиль-им-Зимменталь	Oberwil_im_Simmental
оберенгстринген,швейцария,коммуна,Оберенгстринген	Oberengstringen
олиндин,бразилия,Олиндина	Olindina
орань,франция,коммуна,Орань	Auragne
оцвайлер,германия,коммуна,Оцвайлер	Otzweiler
орандж-бич,соединять штат америка,Орандж-Бич	Orange_Beach,_Alabama
оденсе,дания,коммуна,Оденсе 	Odense_Municipality
окакарара,намибия,Окакарара	Okakarara
оксфорд,соединять штат америка,арканзас,Оксфорд 	Oxford,_Arkansas
орбесан,франция,коммуна,Орбесан	Orbessan
оливето-лукать,италия,коммуна,Оливето-Лукано	Oliveto_Lucano
они-су-буа,франция,коммуна,Оне-су-Буа	Aulnay-sous-Bois
олердол,испания,Олердола	Olèrdola
ошац,германия,город,Ошац	Oschatz
округ 09,германия,дюссельдорф,Округ 09 	District_9,_Düsseldorf
оноре,италия,коммуна,Оноре	Onore
олластра,италия,коммуна,Олластра	Ollastra
орлинци,болгария,село,Орлинци	Orlintsi
оберзюсбах,германия,коммуна,Оберзюсбах	Obersüßbach
осло,соединять штат америка,город,миннесота,Осло 	Oslo,_Minnesota
оймякон,россия,село,Оймякон	Oymyakon
оттирать-тэйл,соединять штат америка,округ,миннесота,Оттер-Тэйл 	Otter_Tail_County,_Minnesota
ошана,намибия,город,Ошана	Oshana_Region
ойос-дель-эспино,испания,Ойос-дель-Эспино	Hoyos_del_Espino
очер,россия,город,Очёр	Ochyor
оклахома,соединять штат америка,оклахома,округ,Оклахома 	Oklahoma_County,_Oklahoma
ойч,германия,деревня,Ойч	Eutzsch
округ брчко,босния и герцеговина,Округ Брчко	Brčko_District
орнолак-юсс-ле-бен,франция,коммуна,Орнолак-Юсса-ле-Бен	Ornolac-Ussat-les-Bains
остервик,германия,город,Остервик	Osterwieck
оленино,россия,посёлок,тверская область,Оленино 	Olenino,_Tver_Oblast
опак,болгария,город,Опака	Opaka
овидиопольский район,украина,посёлок,Овидиопольский район	Ovidiopol_Raion
оберрайсен,германия,коммуна,Оберрайсен	Oberreißen
ожарув,польша,гмина,Ожарув 	Gmina_Ożarów
оренбургский район,россия,город,Оренбургский район	Orenburgsky_District
оппенхайм,германия,город,Оппенхайм	Oppenheim
оссимо,италия,коммуна,Оссимо	Ossimo
огаллал,соединять штат америка,небраска,Огаллала 	Ogallala,_Nebraska
ордабасинский район,казахстан,район,Ордабасинский район	Ordabasy_District
оппоница,австрия,коммуна,Оппониц	Opponitz
октибэхо,соединять штат америка,миссисипи,округ,Октибэха 	Oktibbeha_County,_Mississippi
остербрух,германия,коммуна,Остербрух	Osterbruch
озанс,франция,коммуна,Озанс	Auzances
оструда,польша,город,Оструда	Ostróda
обермайзельштайн,германия,коммуна,Обермайзельштайн	Obermaiselstein
ор,сербия,село,сербия,Ором 	Orom_(Kanjiža)
огродник,польша,сейненский повенок,Огродники 	Ogrodniki,_Sejny_County
оберзонтхайм,германия,коммуна,Оберзонтхайм	Obersontheim
озон,франция,коммуна,ардеш,Озон 	Ozon,_Ardèche
онгуэдив,намибия,город,Онгуэдива	Ongwediva
овани,япония,посёлок,Овани	Ōwani,_Aomori
ольденборстель,германия,коммуна,Ольденборстель	Oldenborstel
ордан-ларрка,франция,коммуна,Ордан-Ларрок	Ordan-Larroque
онджив,ангола,город,Онджива	Ondjiva
оспиталь-де-орбиго,испания,Оспиталь-де-Орбиго	Hospital_de_Órbigo
обинья,франция,алье,коммуна,Обиньи 	Aubigny,_Allier
оберштрайт,германия,коммуна,Оберштрайт	Oberstreit
осейдж,соединять штат америка,округ,миссури,Осейдж 	Osage_County,_Missouri
обок,джибути,Обок	Obock
окоп,болгария,село,Окоп 	Okop,_Yambol_Province
олейт,соединять штат америка,канзас,Олейт 	Olathe,_Kansas
ольденбюттель,германия,коммуна,Ольденбюттель	Oldenbüttel
оренхофен,германия,коммуна,Оренхофен	Orenhofen
остров шмидт,россия,остров,Остров Шмидта	Schmidt_Island
ортоверо,италия,коммуна,Ортоверо	Ortovero
ожиривать,франция,коммуна,Ожирен	Augirein
оберзимменталь,швейцария,округ,Оберзимменталь 	Obersimmental_District
онель,бельгия,коммуна,Онель	Honnelles
орнан,франция,Орнан	Ornans
оисид,япония,посёлок,Оисида	Ōishida
оберрайхенбах,германия,коммуна,шварцвальд,Оберрайхенбах 	Oberreichenbach,_Baden-Württemberg
олмстед,соединять штат америка,округ,миннесота,Олмстед 	Olmsted_County,_Minnesota
орен,бразилия,муниципалитет,пара,Орен 	Ourém,_Pará
одолянуть,польша,Одолянув	Odolanów
омаха,соединять штат америка,арканзас,Омаха 	Omaha,_Arkansas
ольянтайтамбо,перо,Ольянтайтамбо	Ollantaytambo
обердисбах,швейцария,коммуна,Обердисбах	Oberdiessbach
оранж,соединять штат америка,нью-йорк,округ,Оранж 	Orange_County,_New_York
орджано,италия,коммуна,Орджано	Orgiano
обераур,германия,коммуна,Обераурах	Oberaurach
оберхаузен,германия,нойбург-донау,коммуна,Оберхаузен 	Oberhausen_(near_Neuburg)
олье-д’агуа-дас-куньянс,бразилия,Олью-д’Агуа-дас-Куньянс	Olho_d'Água_das_Cunhãs
орган,франция,коммуна,Орган 	Organ,_Hautes-Pyrénées
орламюнде,германия,город,Орламюнде	Orlamünde
ода,франция,коммуна,Од 	Audes
оэнсия,испания,Оэнсия	Oencia
оссонс,франция,коммуна,Оссонс	Aussonce
обер-ольм,германия,коммуна,Обер-Ольм	Ober-Olm
оссон,италия,коммуна,Оссона	Ossona
опс,франция,коммуна,Опс 	Aups
оттинья-лувен-ла-нев,бельгия,коммуна,Оттиньи-Лувен-ла-Нёв	Ottignies-Louvain-la-Neuve
обергеклер,германия,коммуна,Обергеклер	Obergeckler
обурдный,франция,коммуна,Обурден	Haubourdin
опфертсхофен,швейцария,деревня,Опфертсхофен	Opfertshofen
ородар,буркина-фасо,город,Ородара	Orodara
оказный,франция,коммуна,Оказен	Aucazein
обижать,болгария,Обидим	Obidim
озан-монцель,германия,коммуна,Озан-Монцель	Osann-Monzel
остров кверини,россия,остров,Остров Кверини	Querini_Island
обан,франция,франция,коммуна,Обан 	Hauban
олькушский повенок,польша,Олькушский повят	Olkusz_County
округ 04,германия,дюссельдорф,Округ 04 	District_4,_Düsseldorf
оттобрунн,германия,коммуна,Оттобрунн	Ottobrunn
охотский район,россия,Охотский район	Okhotsky_District
отуркпо,нигерия,город,Отуркпо	Otukpo
окль,соединять штат америка,город,миннесота,Окли 	Oklee,_Minnesota
орсан,франция,коммуна,ода,Орсан 	Orsans,_Aude
оуэн-саунд,канада,город,Оуэн-Саунд	Owen_Sound
обермасфельд-гримменталь,германия,коммуна,Обермасфельд-Гримменталь	Obermaßfeld-Grimmenthal
орнильос-де-эресма,испания,Орнильос-де-Эресма	Hornillos_de_Eresma
орьоло-романо,италия,коммуна,Орьоло-Романо	Oriolo_Romano
одерцо,италия,коммуна,Одерцо	Oderzo
обервельц-умгебунг,австрия,коммуна,Обервёльц-Умгебунг	Oberwölz_Umgebung
остров мак-клинток,россия,Остров Мак-Клинтока	MacKlintok_Island
онтория-де-вальдеарадос,испания,Онтория-де-Вальдеарадос	Hontoria_de_Valdearados
ольвен,испания,Ольвена	Olvena
орон,франция,мозель,коммуна,Орон 	Oron,_Moselle
оля-ле-бен,франция,коммуна,Олю-ле-Бен	Aulus-les-Bains
орт-ан-дер-донау,австрия,Орт-ан-дер-Донау	Orth_an_der_Donau
оберрайденбах,германия,коммуна,Оберрайденбах	Oberreidenbach
ортуэри,италия,коммуна,Ортуэри	Ortueri
обригхайм,германия,коммуна,пфальц,Обригхайм 	Obrigheim,_Rhineland-Palatinate
опрталь,хорватия,коммуна,Опрталь	Oprtalj
оттирать-крик,соединять штат америка,флорида,Оттер-Крик 	Otter_Creek,_Florida
о-де-босдаррос,франция,коммуна,О-де-Босдаррос	Haut-de-Bosdarros
орс,швеция,город,Орса	Orsa
оверри,нигерия,город,Оверри	Owerri
оберкульм,швейцария,коммуна,Оберкульм	Oberkulm
оржа,франция,коммуна,Оржё	Orgeux
обливский район,россия,станица,Обливский район	Oblivsky_District
оттервиш,германия,коммуна,Оттервиш	Otterwisch
окюла-рош,молдавия,село,Окюл-Рош	Ochiul_Roș
осиня,республика сербский,населенный пункт,Осиня	Osinja
ортон-дея-марси,италия,коммуна,Ортона-деи-Марси	Ortona_dei_Marsi
оганаван,армения,село,Оганаван	Ohanavan
орловка,киргизия,кеминский район,город,Орловка 	Orlovka,_Kyrgyzstan
оггельсхаузен,германия,коммуна,Оггельсхаузен	Oggelshausen
оучо,намибия,город,Оучо	Outjo
османие,турция,ил,город,Османие 	Osmaniye_Province
ольмедо,италия,коммуна,сардиния,Ольмедо 	Olmedo,_Sardinia
ой-миттельберг,германия,коммуна,Ой-Миттельберг	Oy-Mittelberg
обербюрный,швейцария,коммуна,Обербюрен	Oberbüren
оберфлакс,швейцария,коммуна,Оберфлакс	Oberflachs
олевать-ди-ломеллин,италия,коммуна,Олевано-ди-Ломеллина	Olevano_di_Lomellina
оливенс,испания,муниципалитет,Оливенса	Olivenza
озийака,франция,коммуна,Озийак	Ozillac
оттертейл,соединять штат америка,город,миннесота,Оттертейл 	Ottertail,_Minnesota
ольмут,германия,коммуна,Ольмут	Ollmuth
орвиль,франция,коммуна,кот-д’ор,Орвиль 	Orville,_Côte-d'Or
ормуза,иран,город,Ормуз 	Hormuz,_Iran
ольтрон-ди-сан-маметта,италия,коммуна,Ольтрона-ди-Сан-Маметте	Oltrona_di_San_Mamette
одернхайм-на-глан,германия,коммуна,Одернхайм-на-Глане	Odernheim_am_Glan
отран,франция,коммуна,Отран	Autrans
одесейше,португалия,Одесейше	Odeceixe
окем,великобритания,Окем	Oakham
обербарной,германия,коммуна,Обербарним	Oberbarnim
ош,франция,франция,город,Ош 	Auch
офштайн,германия,коммуна,Офштайн	Offstein
оберефлинген,германия,коммуна,Оберёфлинген	Oberöfflingen
обервисса,франция,коммуна,Обервисс	Obervisse
ольнуа-сюр-сей,франция,коммуна,Ольнуа-сюр-Сей	Aulnois-sur-Seille
остин,соединять штат америка,округ,техас,Остин 	Austin_County,_Texas
орра,франция,коммуна,Орре	Orret
оподеп,мексика,муниципалитет,город,Оподепе 	Opodepe_(municipality)
о-осат,франция,коммуна,О-Осат	Aux-Aussat
оэ,япония,поселок,посёлок,Оэ 	Ōe,_Yamagata
орник,италия,коммуна,Орника	Ornica
опадать,соединять штат америка,вайоминг,Опал 	Opal,_Wyoming
орхус,дания,Орхус	Aarhus
орджоникидзевский район,россия,хакасия,Орджоникидзевский район 	Ordzhonikidzevsky_District,_Republic_of_Khakassia
отрить,франция,коммуна,верхний гаронна,Отрив 	Auterive,_Haute-Garonne
оберлункхофен,швейцария,коммуна,Оберлункхофен	Oberlunkhofen
орландия,бразилия,муниципалитет,Орландия	Orlândia
оук-гров-хайтс,соединять штат америка,арканзас,Оук-Гров-Хайтс 	Oak_Grove_Heights,_Arkansas
ольмуэ,чили,город,Ольмуэ	Olmué
острый,украина,черниговский область,город,Остёр 	Oster
обигарм,таджикистан,посёлок,Обигарм	Obigarm
ойл-тро,соединять штат америка,арканзас,Ойл-Тро 	Oil_Trough,_Arkansas
о’коннор,австралия,район,канберра,О’Коннор 	O'Connor,_Australian_Capital_Territory
оливейра-фортис,бразилия,Оливейра-Фортис	Oliveira_Fortes
оберхофен-они-иннталь,австрия,коммуна,Оберхофен-им-Иннталь	Oberhofen_im_Inntal
ои,япония,посёлок,канагава,Ои 	Ōi,_Kanagawa
осокоровка,украина,село,херсонский область,Осокоровка 	Osokorivka,_Novovorontsovka_Raion
окоталь,никарагуа,город,Окоталь	Ocotal
ольховатский район,россия,посёлок,Ольховатский район	Olkhovatsky_District
остров abc,королевство нидерланды,Острова ABC	ABC_islands_(Lesser_Antilles)
одзать-дель-эмилия,италия,Одзано-дель-Эмилия	Ozzano_dell'Emilia
октябрьский район,россия,оренбургский область,село,Октябрьский район 	Oktyabrsky_District,_Orenburg_Oblast
остров уайт,великобритания,Остров Уайт	Isle_of_Wight
обан,великобритания,Обан	Oban
орджоникидзевский,россия,посёлок,Орджоникидзевская	Ordzhonikidzevskaya
октябрьский,россия,мурманский область,Октябрьский 	Oktyabrsky,_Murmansk_Oblast
обервайда,германия,коммуна,Обервайд	Oberweid
оппеано,италия,коммуна,Оппеано	Oppeano
ольягуэ,чили,посёлок,Ольягуэ	Ollagüe,_Chile
оржицкий район,украина,посёлок,Оржицкий район	Orzhytsia_Raion
осчук,мексика,муниципалитет,Осчук 	Oxchuc
огуз,азербайджан,город,Огуз 	Oghuz_(city)
окаихау,новый зеландия,Окаихау	Okaihau
олорон-сент-мари,франция,город,Олорон-Сент-Мари	Oloron-Sainte-Marie
оссуччо,италия,коммуна,Оссуччо	Ossuccio
оберрайхенбах,германия,коммуна,средний франкония,Оберрайхенбах 	Oberreichenbach,_Bavaria
одырци,болгария,село,Одырци	Odartsi
ольдеруп,германия,коммуна,Ольдеруп	Olderup
орадя,румыния,город,Орадя	Oradea
орнильос-де-серрато,испания,Орнильос-де-Серрато	Hornillos_de_Cerrato
о-пюизо,франция,коммуна,О-Пюизо	Eaux-Puiseaux
ота,франция,коммуна,Ота 	Ota,_Corse-du-Sud
орсьер,франция,коммуна,Орсьер	Orcières
обердоллендорф,германия,Обердоллендорф	Oberdollendorf
октябрьский,украина,посёлок,красногвардейский район,Октябрьское 	Oktiabrske
окосокоаутло-де-эспинос,мексика,муниципалитет,Окосокоаутла-де-Эспиноса 	Ocozocoautla_de_Espinosa
онориу-серп,бразилия,Онориу-Серпа	Honório_Serpa
оцуть,япония,посёлок,Оцути	Ōtsuchi,_Iwate
ольбий-темпьо,италия,провинция,Ольбия-Темпьо	Province_of_Olbia-Tempio
одесский район,россия,Одесский район	Odessky_District
остров ратманова,россия,остров,Остров Ратманова	Big_Diomede
одвисла,польша,село,Одвисле	Odwiśle
озимек,польша,Озимек	Ozimek
он,франция,коммуна,верхний гаронна,Он 	Eaunes
ортонов,италия,коммуна,Ортоново	Ortonovo
орел,россия,город,Орёл 	Oryol
оулафсфьордюр,исландия,город,Оулафсфьордюр	Ólafsfjörður
оппенвайлер,германия,коммуна,Оппенвайлер	Oppenweiler
отрадненский район,россия,станица,Отрадненский район	Otradnensky_District
остер,германия,коммуна,Острах	Ostrach
обригхайм,германия,коммуна,баден,Обригхайм 	Obrigheim
орадя,франция,коммуна,Ораде	Auradé
оломон,италия,коммуна,Оломон	Ollomont
обанж,бельгия,коммуна,Обанж	Aubange
орначос,испания,Орначос	Hornachos
орун,италия,коммуна,Оруне	Orune
онсье,франция,коммуна,Онсьё	Oncieu
оамисирасато,япония,город,Оамисирасато	Ōamishirasato
оттирать,германия,коммуна,Оттер	Otter,_Germany
ортранд,германия,город,Ортранд	Ortrand
ож,франция,коммуна,арденны,Ож 	Auge,_Ardennes
оканье,испания,населённый пункт,Оканья	Ocaña,_Spain
ор,германия,район,Оре 	Ohrekreis
оффинген,германия,коммуна,Оффинген	Offingen
ораниенбаум-верлиц,германия,город,Ораниенбаум-Вёрлиц	Oranienbaum-Wörlitz
османие,турция,Османие	Osmaniye
обербойхинген,германия,коммуна,Обербойхинген	Oberboihingen
ольсберг,швейцария,коммуна,аргау,Ольсберг 	Olsberg,_Aargau
остиано,италия,коммуна,Остиано	Ostiano
о-нкам,камерун,департамент,О-Нкам 	Haut-Nkam
оффенбах,германия,район,Оффенбах 	Offenbach_(district)
олиен,италия,коммуна,Олиена	Oliena
орхей,молдавия,город,Орхей	Orhei
остенфельд,германия,коммуна,хузум,Остенфельд 	Ostenfeld,_Nordfriesland
овервный,нидерланды,город,Овервен	Overveen
озон,франция,верхний пиренеи,коммуна,Озон 	Ozon,_Hautes-Pyrénées
орибай,франция,коммуна,Орибай	Auribail
оток,хорватия,город,Оток	Otok,_Vukovar-Srijem_County
остров аделаида,россия,Остров Аделаиды	Adelaide_Island_(Russia)
олбери,австралия,город,Олбери	Albury
остальрик,испания,муниципалитет,Остальрик	Hostalric
олишканы,молдавия,село,Олишканы	Olișcani
орхив,испания,муниципалитет,Орхива	Órgiva
онгол,индия,город,Онголе	Ongole
опмер,нидерланды,город,Опмер	Opmeer
оруэ,франция,коммуна,Оруэ	Aurouër
оберне,франция,муниципалитет,Оберне	Obernai
олимпия,бразилия,сан-паулу,Олимпия 	Olímpia
оберуцвиль,швейцария,коммуна,Оберуцвиль	Oberuzwil
оппидо-лучано,италия,коммуна,Оппидо-Лучано	Oppido_Lucano
остров морской конек,соединять штат америка,чукотский море,Острова Морского конька 	Seahorse_Islands
ордьяр,франция,коммуна,Ордьяр	Ordiarp
орнасья,франция,коммуна,Орнасьё	Ornacieux
олесница,польша,Олесница	Oleśnica
оффенхаузен,германия,коммуна,средний франкония,Оффенхаузен 	Offenhausen,_Germany
оймяконский улус,россия,Оймяконский улус	Oymyakonsky_District
охорн,германия,коммуна,Охорн	Ohorn
озерный провинция,южный судан,город,Озёрная провинция	Lakes_(state)
обюссон,франция,коммуна,Обюссон 	Aubusson,_Creuse
ораховац,республика косово,город,Ораховац	Orahovac
одрие,франция,коммуна,Одриё	Audrieu
охотск,россия,Охотск	Okhotsk
ом,италия,коммуна,Оме 	Ome,_Lombardy
ожи,франция,коммуна,эна,Ожи 	Augy,_Aisne
оспиталетто,италия,город,Оспиталетто	Ospitaletto
ортигейр,бразилия,бразилия,Ортигейра 	Ortigueira,_Paraná
обершлеттенбах,германия,коммуна,Обершлеттенбах	Oberschlettenbach
обертрум,австрия,Обертрум	Obertrum
отмарзинген,швейцария,коммуна,Отмарзинген	Othmarsingen
обердорф,швейцария,коммуна,базель-ланды,Обердорф 	Oberdorf,_Basel-Landschaft
оккенфельс,германия,коммуна,Оккенфельс	Ockenfels
османгази,турция,район,Османгази	Osmangazi
остермитинг,австрия,Остермитинг	Ostermiething
отам,япония,село,Отама	Ōtama,_Fukushima
омон-обрак,франция,коммуна,Омон-Обрак	Aumont-Aubrac
оберндорф-ама-неккар,германия,город,Оберндорф-ам-Неккар	Oberndorf_am_Neckar
огастый,соединять штат америка,город,джорджия,Огаста 	Augusta,_Georgia
ольхинг,германия,город,Ольхинг	Olching
оз,франция,коммуна,изер,Оз 	Oz,_Isère
онье,испания,Онья	Oña
орадур-фаня,франция,коммуна,Орадур-Фане	Oradour-Fanais
оберхайн,германия,коммуна,Оберхайн	Oberhain
она,франция,коммуна,Она 	Aunat
олан,франция,коммуна,Олан	Olemps
огути,япония,посёлок,Огути	Ōguchi,_Aichi
октябрьский,россия,город,Октябрьский 	Oktyabrsky,_Republic_of_Bashkortostan
ортеццано,италия,Ортеццано	Ortezzano
одергем,бельгия,Одергем	Auderghem
ор-жош,бельгия,коммуна,Ор-Жош	Orp-Jauche
оберхоннефельд-гиренд,германия,коммуна,Оберхоннефельд-Гиренд	Oberhonnefeld-Gierend
обершторх,австрия,коммуна,Обершторха	Oberstorcha
огастый,соединять штат америка,город,мэн,Огаста 	Augusta,_Maine
обхаузен,германия,коммуна,Обхаузен	Obhausen
один,соединять штат америка,город,миннесота,Один 	Odin,_Minnesota
олизи-прима,франция,коммуна,Олизи-Прима	Olizy-Primat
они,франция,муниципалитет,Они 	Osny
ор,япония,поселок,посёлок,Ора 	Ōra,_Gunma
отфаж,франция,коммуна,Отфаж	Hautefage
омуртаг,болгария,община,Омуртаг 	Omurtag_Municipality
он,франция,коммуна,канталь,Он 	Omps
отьон,франция,коммуна,Отьон	Haution
острогожский район,россия,город,Острогожский район	Ostrogozhsky_District
овидиопольский район,украина,Овидиопольский район	Ovidiopol_Raion
остерцелль,германия,коммуна,Остерцелль	Osterzell
орриос,испания,муниципалитет,Орриос	Orrios
остров большой олений,россия,посёлок,Остров Большой Олений	Ostrov_Bolshoy_Oleny
одерберг,германия,город,Одерберг	Oderberg
оберндорф-ан-дер-мельк,австрия,Оберндорф-ан-дер-Мельк	Oberndorf_an_der_Melk
охуд,азербайджан,село,Охуд 	Oxud
ольховский район,россия,село,Ольховский район	Olkhovsky_District
оберхахинг,германия,коммуна,Оберхахинг	Oberhaching
обер-флерсхайм,германия,коммуна,Обер-Флёрсхайм	Ober-Flörsheim
оксфорд,великобритания,город,Оксфорд	Oxford
оверейс,бельгия,муниципалитет,Оверейсе	Overijse
остхаузен-вюльферсхаузен,германия,коммуна,Остхаузен-Вюльферсхаузен	Osthausen-Wülfershausen
оберфеллах,австрия,Оберфеллах	Obervellach
озоркув,польша,Озоркув	Ozorków
орешник,болгария,село,хасковский область,Орешник 	Oreshnik
обертульба,германия,коммуна,Обертульба	Oberthulba
орм-э-виль,франция,коммуна,Орм-э-Виль	Ormes-et-Ville
оберхаймбах,германия,коммуна,Оберхаймбах	Oberheimbach
обервилья,франция,коммуна,Обервилье	Aubervilliers
область народность южный эфиопия,эфиопия,город,Область Народностей Южной Эфиопии	Southern_Nations,_Nationalities,_and_Peoples'_Region
ординариат бразилия для верный восточный обряд,бразилия,Ординариат Бразилии для верных восточного обряда	Ordinariate_for_Eastern_Catholics_in_Brazil
омидийе,иран,город,Омидийе	Omidiyeh
орахов,босния и герцеговина,градишка,Орахова 	Orahova
ос-ан-асп,франция,коммуна,Ос-ан-Асп	Osse-en-Aspe
омутий,намибия,город,Омутия	Omuthiya
оберегерь,швейцария,коммуна,Оберегери	Oberägeri
обернайзен,германия,коммуна,Обернайзен	Oberneisen
озилья,италия,коммуна,Озилья	Osiglia
осана,франция,франция,коммуна,Осан 	Ossen
оберштамхайм,швейцария,коммуна,Оберштамхайм	Oberstammheim
оберндорф-бай-зальцбург,австрия,город,Оберндорф-бай-Зальцбург	Oberndorf_bei_Salzburg
орхон,монголия,аймак,Орхон 	Orkhon_Province
ойленберг,германия,коммуна,вестервальд,Ойленберг 	Eulenberg
орать,франция,коммуна,изер,Ори 	Auris,_Isère
олюдениз,турция,Олюдениз	Ölüdeniz
ольштынский повенок,польша,город,Ольштынский повят	Olsztyn_County
огайо,соединять штат америка,штат,Огайо	Ohio
октябрьский район,россия,амурский область,село,Октябрьский район 	Oktyabrsky_District,_Amur_Oblast
оливия,соединять штат америка,город,миннесота,Оливия 	Olivia,_Minnesota
обершвайнбах,германия,коммуна,Обершвайнбах	Oberschweinbach
остилья,италия,коммуна,Остилья	Ostiglia
олык,украина,посёлок,Олыка	Olyka
ост,франция,мозель,коммуна,Ост 	Hoste,_Moselle
ордынский район,россия,Ордынский район	Ordynsky_District
отрадный,россия,район москва,Отрадное 	Otradnoye_District
османабад,индия,город,Османабад	Osmanabad
опплиген,швейцария,коммуна,Опплиген	Oppligen
олесный,польша,олесненский повенок,гмина,Олесно 	Gmina_Olesno,_Opole_Voivodeship
ольский городской округ,россия,Ольский городской округ	Olsky_District
окроугло,чехия,община,Окроугло	Okrouhlo
оппенан,франция,коммуна,Оппенан	Oppenans
онд,испания,муниципалитет,валенсия,Онда 	Onda,_Castellón
остров мария,мексика,архипелаг,Острова Марии	Islas_Marías
орешац,сербия,село,Орешац	Orešac
олиас-дель-рей,испания,Олиас-дель-Рей	Olías_del_Rey
одинцовский район,россия,Одинцовский район	Odintsovsky_District
окфен,германия,коммуна,Окфен	Ockfen
охрить,ирландия,деревня,голуэй,Охрим 	Aughrim,_County_Galway
обехо,испания,населённый пункт,Обехо	Obejo
ормалинген,швейцария,коммуна,Ормалинген	Ormalingen
оквилл,канада,онтарио,город,Оквилл 	Oakville,_Ontario
осех-де-сахамбре,испания,Осеха-де-Сахамбре	Oseja_de_Sajambre
оттенбах,швейцария,цюрих,коммуна,Оттенбах 	Ottenbach,_Switzerland
ольденико,италия,коммуна,Ольденико	Oldenico
омери,франция,коммуна,Омери	Osmery
остроруг,польша,Остроруг	Ostroróg
опедет,франция,коммуна,Опедет	Oppedette
оньякса,франция,коммуна,Оньякс	Augnax
олиол,испания,муниципалитет,Олиола	Oliola
острица,германия,город,Остриц	Ostritz
орловский область,россия,город,Орловская область	Oryol_Oblast
осеан,камерун,департамент,Осеан 	Océan
орать,украина,львовский область,село,Ораны 	Orany,_Ukraine
отр-ле-гре,франция,коммуна,Отре-ле-Гре	Autrey-lès-Gray
обинья-ле-пот,франция,коммуна,Обиньи-ле-Поте	Aubigny-les-Pothées
о’хиггинс,чили,коммуна,О’Хиггинс 	O'Higgins,_Chile
омон,франция,коммуна,Омон 	Omont
огре,латвия,Огре	Ogre,_Latvia
остроленкский повенок,польша,город,Остроленкский повят	Ostrołęka_County
олюторский район,россия,Олюторский район	Olyutorsky_District
ойленбис,германия,коммуна,Ойленбис	Eulenbis
обервиль-лили,швейцария,коммуна,Обервиль-Лили	Oberwil-Lieli
оберкирха,германия,баден,город,Оберкирх 	Oberkirch_(Baden)
осинский район,россия,город,пермский край,Осинский район 	Osinsky_District,_Perm_Krai
остров возрождение,казахстан,Остров Возрождения	Vozrozhdeniya_Island
от-дюи,франция,коммуна,От-Дюи	Hautes-Duyes
органие,испания,Органья	Organyà
ория,италия,апулия,коммуна,Ория 	Oria,_Apulia
оберкохен,германия,город,Оберкохен	Oberkochen
октябрьский район,россия,посёлок,ростовский область,Октябрьский район 	Oktyabrsky_District,_Rostov_Oblast
отос,испания,Отос	Otos,_Valencia
обинья-ан-плен,франция,коммуна,Обиньи-ан-Плен	Aubigny-en-Plaine
опуво,намибия,столица,Опуво	Opuwo
орловский район,россия,ростовский область,Орловский район 	Orlovsky_District,_Rostov_Oblast
ольденхюттен,германия,коммуна,Ольденхюттен	Oldenhütten
обер-графендорф,австрия,Обер-Графендорф	Ober-Grafendorf
огден,соединять штат америка,арканзас,Огден 	Ogden,_Arkansas
оффенхаузен,австрия,верхний австрия,Оффенхаузен 	Offenhausen,_Austria
оберрота,германия,коммуна,Оберрот	Oberroth
оффаль,ирландия,графство,Оффали 	County_Offaly
остенфельд,германия,рендсбург,коммуна,Остенфельд 	Ostenfeld,_Rendsburg-Eckernförde
обен,франция,коммуна,аверона,Обен 	Aubin,_Aveyron
одоевский район,россия,посёлок,Одоевский район	Odoyevsky_District
оберн,соединять штат америка,город,мэн,Оберн 	Auburn,_Maine
отуазон,франция,коммуна,Отуазон	Authoison
ольгин,куба,город,Ольгин 	Holguín
ольчененго,италия,коммуна,Ольчененго	Olcenengo
оберурзель,германия,город,Оберурзель	Oberursel_(Taunus)
оулафсвик,исландия,город,Оулафсвик	Ólafsvík
обаншель-о-буа,франция,коммуна,Обаншёль-о-Буа	Aubencheul-aux-Bois
опаринский район,россия,Опаринский район	Oparinsky_District
орибо-сюр-сьянь,франция,коммуна,Орибо-сюр-Сьянь	Auribeau-sur-Siagne
обернойкирхен,германия,верхний бавария,коммуна,Обернойкирхен 	Oberneukirchen
октябрьский район,россия,челябинский область,Октябрьский район 	Oktyabrsky_District,_Chelyabinsk_Oblast
олива-де-пласенсия,испания,Олива-де-Пласенсия	Oliva_de_Plasencia
оберхаузен,германия,город,Оберхаузен	Oberhausen
оратовский район,украина,Оратовский район	Orativ_Raion
оропес,испания,муниципалитет,Оропеса	Oropesa,_Spain
осекать,польша,польша,Осек 	Osiek,_Świętokrzyskie_Voivodeship
остерспай,германия,коммуна,Остерспай	Osterspai
остров беккер,россия,остров,Остров Беккера	Becker_Island
островец-свентокшиский,польша,Островец-Свентокшиский	Ostrowiec_Świętokrzyski
ольменет,италия,коммуна,Ольменета	Olmeneta
одинцовский район,россия,город,Одинцовский район	Odintsovsky_District
обершенау,германия,коммуна,Обершёнау	Oberschönau
олеа-де-боэдо,испания,муниципалитет,Олеа-де-Боэдо	Olea_de_Boedo
овенс,ирландия,деревня,Овенс	Ovens,_County_Cork
окинский район,россия,Окинский район	Okinsky_District
орвиль,франция,коммуна,верхний гаронна,Орвиль 	Aureville
оберлар,германия,коммуна,Оберлар	Oberlahr
ольмет-ди-туда,франция,коммуна,Ольмета-ди-Туда	Olmeta-di-Tuda
оффаненго,италия,коммуна,Оффаненго	Offanengo
орехово-зуевский район,россия,город,Орехово-Зуевский район	Orekhovo-Zuyevsky_District
ор-йехуда,израиль,город,Ор-Йехуда	Or_Yehuda
оберн,соединять штат америка,нью-йорк,город,Оберн 	Auburn,_New_York
одонвиль,франция,коммуна,Одонвиль	Haudonville
ойскирхен,германия,район,Ойскирхен 	Euskirchen_(district)
осса-ле-труа-мезон,франция,коммуна,Оссе-ле-Труа-Мезон	Ossey-les-Trois-Maisons
оффенхайм,германия,коммуна,Оффенхайм	Offenheim
олиус,испания,Олиус	Olius
окен,нигерия,город,Окене	Okene
оберостендорф,германия,коммуна,Оберостендорф	Oberostendorf
ойя-де-алька,испания,район,Ойя-де-Алькой	Alcoià
отара,япония,Отару	Otaru,_Hokkaido
оберхоф,швейцария,коммуна,аргау,Оберхоф 	Oberhof,_Aargau
отгон,монголия,Отгон	Otgon,_Zavkhan
орос,индия,индия,город,Орос 	Oros
огодж,нигерия,нигерия,Огоджа 	Ogoja
ожерелие,россия,город,Ожерелье 	Ozherelye
олдекерк,нидерланды,Олдекерк	Oldekerk
оттавьяно,италия,коммуна,Оттавьяно	Ottaviano
опан,болгария,болгария,село,Опан 	Opan
ортигуэл,испания,Ортигуэла	Hortigüela
охрид,болгария,село,Охрид 	Ohrid,_Bulgaria
оса,россия,город,Оса 	Osa,_Perm_Krai
опольский повенок,польша,люблинский воеводство,город,Опольский повят 	Opole_Lubelskie_County
опольский повенок,польша,опольский воеводство,город,Опольский повят 	Opole_County
омский район,россия,Омский район	Omsky_District
олива-де-ла-фронтер,испания,муниципалитет,Олива-де-ла-Фронтера	Oliva_de_la_Frontera
ожеш,польша,Ожеше	Orzesze
оскарсхамна,швеция,город,Оскарсхамн	Oskarshamn
обереэ-штрохайх,германия,коммуна,Обереэ-Штрохайх	Oberehe-Stroheich
омсукчанский городской округ,россия,Омсукчанский городской округ	Omsukchansky_District
ольяна,испания,Ольяна	Oliana
ольястро-чиленто,италия,коммуна,Ольястро-Чиленто	Ogliastro_Cilento
олостой,испания,Олост	Olost
остный,германия,ост,коммуна,Остен 	Osten
одзеро,италия,коммуна,Одзеро	Ozzero
ошерслебен,германия,город,Ошерслебен	Oschersleben
онтоба,испания,Онтоба	Hontoba
оираса,япония,посёлок,Оирасе	Oirase,_Aomori
оклай,хорватия,Оклай	Oklaj
орань,италия,коммуна,Орани	Orani,_Sardinia
ормелла,италия,коммуна,Ормелле	Ormelle
оушен-бриз-парк,соединять штат америка,флорида,Оушен-Бриз-Парк 	Ocean_Breeze,_Florida
оруро,боливия,департамент,город,Оруро 	Oruro_Department
окинава,япония,город,Окинава 	Okinawa,_Okinawa
офтердинген,германия,коммуна,Офтердинген	Ofterdingen
ористать,италия,провинция,Ористано 	Province_of_Oristano
оржев,украина,посёлок,Оржев	Orzhiv
осех,испания,Осеха	Oseja
орвен,швейцария,коммуна,Орвен	Orvin
обертсхаузен,германия,город,Обертсхаузен	Obertshausen
орловский район,россия,кировский область,Орловский район 	Orlovsky_District,_Kirov_Oblast
оберасбах,германия,город,Оберасбах	Oberasbach
обливский район,россия,Обливский район	Oblivsky_District
оахак,мексика,штат,Оахака 	Oaxaca
оливето-ларио,италия,коммуна,Оливето-Ларио	Oliveto_Lario
остров эрнст тельман,куба,остров,Остров Эрнста Тельмана	Ernst_Thälmann_Island
орегон,соединять штат америка,округ,миссури,Орегон 	Oregon_County,_Missouri
окотлан,мексика,тласкивать,город,Окотлан 	Ocotlán,_Tlaxcala
орен,франция,коммуна,кот-д’ор,Орен 	Orain
омарур,намибия,город,Омаруру	Omaruru,_Namibia
ор,швеция,швеция,Оре 	Åre
ом,великобритания,город,Ома 	Omagh
отон,франция,коммуна,эн,Отон 	Hotonnes
ожак,франция,коммуна,Ожак	Aujac_(Charente-Maritime)
оберндорф-бай-шваненштадт,австрия,коммуна,Оберндорф-бай-Шваненштадт	Oberndorf_bei_Schwanenstadt
онгудайский район,россия,село,Онгудайский район	Ongudaysky_District
ост,франция,коммуна,Оста	Hosta,_Pyrénées-Atlantiques
оттерштадт,германия,коммуна,Оттерштадт	Otterstadt
оберн,соединять штат америка,город,алабама,Оберн 	Auburn,_Alabama
онайда,соединять штат америка,округ,айдахо,Онайда 	Oneida_County,_Idaho
олекминский район,россия,город,Олёкминский район	Olyokminsky_District
овчар,польша,село,гмина сенкова,Овчары 	Owczary,_Gorlice_County
омельонс,испания,Омельонс	Els_Omellons
острожский район,украина,город,Острожский район	Ostroh_Raion
онгудайский район,россия,Онгудайский район	Ongudaysky_District
олинал,мексика,посёлок,Олинала	Olinalá
олесный,польша,город,Олесно	Olesno
обен,франция,коммуна,Обена	Aubenas
оберхофен,швейцария,коммуна,Оберхофен	Oberhofen,_Aargau
осес,франция,коммуна,Осес	Ossès
орсомарсо,италия,коммуна,Орсомарсо	Orsomarso
